,name,surface,won,lost,surface_total,total_matches,win_rate
0,A Ferguson,Grass,1,1,2,2,50.0
1,A G Barker,Grass,1,1,2,2,50.0
2,A Galbraith,Grass,1,1,2,2,50.0
3,A J Gould,Grass,1,1,2,2,50.0
4,A Jackson,Grass,1,1,2,2,50.0
5,A Macdonald,Clay,1,1,2,2,50.0
6,AJ Mitha,Grass,1,1,2,2,50.0
7,Aaron Krickstein,Carpet,48,48,96,653,50.0
8,Aaron Krickstein,Clay,122,87,209,653,58.37
9,Aaron Krickstein,Grass,12,9,21,653,57.14
10,Aaron Krickstein,Hard,213,114,327,653,65.14
11,Abd Hazli Bin Zainuddin,Hard,1,3,4,4,25.0
12,Abdel Aslam Mahmoudi,Clay,1,4,5,5,20.0
13,Abdelhak Hameurlaine,Clay,3,9,12,12,25.0
14,Abdul Khalek Nadini,Hard,1,5,6,6,16.67
15,Abdul Rahman Shehab,Hard,1,3,4,4,25.0
16,Abdullah Maqdas,Clay,5,1,6,15,83.33
17,Abdullah Maqdas,Hard,4,5,9,15,44.44
18,Abe Segal,Clay,1,3,4,13,25.0
19,Abe Segal,Grass,1,3,4,13,25.0
20,Abe Segal,Hard,2,3,5,13,40.0
21,Abou Berthe,Hard,1,9,10,10,10.0
22,Adam Chadaj,Clay,3,1,4,4,75.0
23,Adam Kellner,Carpet,2,2,4,13,50.0
24,Adam Kellner,Clay,1,3,4,13,25.0
25,Adam Kellner,Hard,3,2,5,13,60.0
26,Adam Malik,Carpet,4,2,6,22,66.67
27,Adam Malik,Clay,1,3,4,22,25.0
28,Adam Malik,Hard,9,3,12,22,75.0
29,Adam Moundir,Clay,1,1,2,2,50.0
30,Adam Pavlasek,Clay,5,4,9,11,55.56
31,Adam Pavlasek,Grass,1,1,2,11,50.0
32,Adam Skrzypczak,Clay,3,1,4,4,75.0
33,Adam Thompson,Hard,2,2,4,4,50.0
34,Adelo Abadia,Clay,2,4,6,6,33.33
35,Aditya Hari Sasongko,Hard,2,5,7,7,28.57
36,Adolfo Daniel Vallejo,Clay,2,1,3,3,66.67
37,Adolfo Gonzalez,Clay,3,1,4,4,75.0
38,Adrian Andreev,Hard,2,5,7,7,28.57
39,Adrian Cruciat,Clay,1,2,3,3,33.33
40,Adrian Garcia,Clay,9,15,24,38,37.5
41,Adrian Garcia,Hard,4,10,14,38,28.57
42,Adrian Graimprey,Carpet,3,3,6,6,50.0
43,Adrian Mannarino,Clay,14,42,56,448,25.0
44,Adrian Mannarino,Grass,49,34,83,448,59.04
45,Adrian Mannarino,Hard,144,165,309,448,46.6
46,Adrian Marcu,Carpet,1,3,4,26,25.0
47,Adrian Marcu,Clay,11,11,22,26,50.0
48,Adrian Menendez Maceiras,Clay,1,5,6,24,16.67
49,Adrian Menendez Maceiras,Grass,1,3,4,24,25.0
50,Adrian Menendez Maceiras,Hard,4,10,14,24,28.57
51,Adrian Ungur,Clay,11,26,37,53,29.73
52,Adrian Ungur,Hard,6,10,16,53,37.5
53,Adrian Voinea,Carpet,13,20,33,312,39.39
54,Adrian Voinea,Clay,70,80,150,312,46.67
55,Adrian Voinea,Grass,5,14,19,312,26.32
56,Adrian Voinea,Hard,48,62,110,312,43.64
57,Adriano Panatta,Carpet,48,46,94,645,51.06
58,Adriano Panatta,Clay,291,129,420,645,69.29
59,Adriano Panatta,Grass,26,22,48,645,54.17
60,Adriano Panatta,Hard,43,40,83,645,51.81
61,Agustin Calleri,Carpet,5,8,13,399,38.46
62,Agustin Calleri,Clay,135,90,225,399,60.0
63,Agustin Calleri,Grass,4,10,14,399,28.57
64,Agustin Calleri,Hard,66,81,147,399,44.9
65,Agustin Garizzio,Clay,1,2,3,3,33.33
66,Agustin Moreno,Carpet,1,2,3,24,33.33
67,Agustin Moreno,Clay,5,9,14,24,35.71
68,Agustin Moreno,Hard,1,6,7,24,14.29
69,Ahmad Rabeea Muhammad,Clay,1,1,2,14,50.0
70,Ahmad Rabeea Muhammad,Hard,3,9,12,14,25.0
71,Ahmed Ben Omar,Clay,1,2,3,3,33.33
72,Ahmed El Mehelmy,Clay,14,17,31,36,45.16
73,Ahmed El Mehelmy,Hard,2,3,5,36,40.0
74,Aisam Ul Haq Qureshi,Clay,7,6,13,71,53.85
75,Aisam Ul Haq Qureshi,Grass,19,13,32,71,59.38
76,Aisam Ul Haq Qureshi,Hard,13,13,26,71,50.0
77,Aivaras Balzekas,Carpet,1,1,2,2,50.0
78,Ajeet Rai,Hard,1,2,3,3,33.33
79,Aki Rahunen,Carpet,11,11,22,79,50.0
80,Aki Rahunen,Clay,14,16,30,79,46.67
81,Aki Rahunen,Grass,2,3,5,79,40.0
82,Aki Rahunen,Hard,6,16,22,79,27.27
83,Akinori Naguro,Clay,2,4,6,6,33.33
84,Akira Santillan,Grass,1,1,2,7,50.0
85,Akira Santillan,Hard,1,4,5,7,20.0
86,Al Parker,Hard,1,7,8,8,12.5
87,Alaaddin Karagoz,Clay,6,7,13,17,46.15
88,Alaaddin Karagoz,Hard,2,2,4,17,50.0
89,Alain Brichant,Hard,1,3,4,4,25.0
90,Alan Fox,Clay,2,2,4,20,50.0
91,Alan Fox,Grass,4,4,8,20,50.0
92,Alan Fox,Hard,3,5,8,20,37.5
93,Alan Mackin,Grass,1,6,7,7,14.29
94,Alan Schwarz,Hard,1,1,2,2,50.0
95,Albano Olivetti,Hard,5,6,11,11,45.45
96,Albert Chang,Carpet,4,5,9,23,44.44
97,Albert Chang,Hard,3,11,14,23,21.43
98,Albert Costa,Carpet,8,23,31,662,25.81
99,Albert Costa,Clay,274,138,412,662,66.5
100,Albert Costa,Grass,2,7,9,662,22.22
101,Albert Costa,Hard,104,106,210,662,49.52
102,Albert Gaertner,Hard,1,1,2,2,50.0
103,Albert Montanes,Clay,213,186,399,542,53.38
104,Albert Montanes,Grass,6,13,19,542,31.58
105,Albert Montanes,Hard,38,86,124,542,30.65
106,Albert Portas,Carpet,1,8,9,340,11.11
107,Albert Portas,Clay,127,141,268,340,47.39
108,Albert Portas,Grass,3,11,14,340,21.43
109,Albert Portas,Hard,11,38,49,340,22.45
110,Albert Ramos,Clay,152,127,279,470,54.48
111,Albert Ramos,Grass,6,12,18,470,33.33
112,Albert Ramos,Hard,65,108,173,470,37.57
113,Albert Viviani,Clay,1,3,4,4,25.0
114,Alberto Berasategui,Carpet,7,18,25,476,28.0
115,Alberto Berasategui,Clay,239,130,369,476,64.77
116,Alberto Berasategui,Hard,33,49,82,476,40.24
117,Alberto Brause,Clay,1,1,2,2,50.0
118,Alberto Lim,Hard,2,3,5,5,40.0
119,Alberto Mancini,Carpet,4,7,11,276,36.36
120,Alberto Mancini,Clay,117,82,199,276,58.79
121,Alberto Mancini,Grass,1,2,3,276,33.33
122,Alberto Mancini,Hard,28,35,63,276,44.44
123,Alberto Martin,Carpet,1,5,6,488,16.67
124,Alberto Martin,Clay,157,147,304,488,51.64
125,Alberto Martin,Grass,8,17,25,488,32.0
126,Alberto Martin,Hard,53,100,153,488,34.64
127,Alberto Martorell,Clay,1,6,7,7,14.29
128,Alberto Paris,Clay,1,3,4,4,25.0
129,Alberto Riba,Clay,2,1,3,3,66.67
130,Alberto Tous,Carpet,1,3,4,101,25.0
131,Alberto Tous,Clay,39,52,91,101,42.86
132,Alberto Tous,Hard,1,5,6,101,16.67
133,Aldin Setkic,Clay,6,4,10,15,60.0
134,Aldin Setkic,Hard,2,3,5,15,40.0
135,Alejandro Aramburu,Clay,3,11,14,16,21.43
136,Alejandro Aramburu,Hard,1,1,2,16,50.0
137,Alejandro Aramburu Acuna,Clay,11,12,23,26,47.83
138,Alejandro Aramburu Acuna,Hard,1,2,3,26,33.33
139,Alejandro Cortes,Clay,19,26,45,58,42.22
140,Alejandro Cortes,Hard,5,8,13,58,38.46
141,Alejandro Davidovich Fokina,Clay,5,10,15,35,33.33
142,Alejandro Davidovich Fokina,Hard,13,7,20,35,65.0
143,Alejandro Falla,Carpet,3,3,6,283,50.0
144,Alejandro Falla,Clay,30,40,70,283,42.86
145,Alejandro Falla,Grass,16,25,41,283,39.02
146,Alejandro Falla,Hard,65,101,166,283,39.16
147,Alejandro Ganzabal,Clay,44,63,107,114,41.12
148,Alejandro Ganzabal,Hard,2,5,7,114,28.57
149,Alejandro Gattiker,Carpet,1,2,3,26,33.33
150,Alejandro Gattiker,Clay,3,20,23,26,13.04
151,Alejandro Gomez Gb42,Hard,1,1,2,2,50.0
152,Alejandro Gonzalez,Clay,7,18,25,58,28.0
153,Alejandro Gonzalez,Hard,11,22,33,58,33.33
154,Alejandro Hernandez,Carpet,3,4,7,75,42.86
155,Alejandro Hernandez,Clay,21,19,40,75,52.5
156,Alejandro Hernandez,Hard,13,15,28,75,46.43
157,Alejandro Olivera,Hard,1,3,4,4,25.0
158,Alejandro Olmedo,Carpet,1,2,3,83,33.33
159,Alejandro Olmedo,Clay,3,8,11,83,27.27
160,Alejandro Olmedo,Grass,13,11,24,83,54.17
161,Alejandro Olmedo,Hard,23,22,45,83,51.11
162,Alejandro Pierola,Carpet,1,4,5,63,20.0
163,Alejandro Pierola,Clay,16,42,58,63,27.59
164,Alejandro Tabilo,Clay,1,1,2,6,50.0
165,Alejandro Tabilo,Hard,2,2,4,6,50.0
166,Alejo Mancisidor,Clay,3,19,22,26,13.64
167,Alejo Mancisidor,Hard,2,2,4,26,50.0
168,Aleksandar Vukic,Hard,1,3,4,4,25.0
169,Aleksandr Nedovyesov,Clay,2,8,10,32,20.0
170,Aleksandr Nedovyesov,Grass,1,4,5,32,20.0
171,Aleksandr Nedovyesov,Hard,3,14,17,32,17.65
172,Aleksandre Metreveli,Clay,1,1,2,6,50.0
173,Aleksandre Metreveli,Hard,1,3,4,6,25.0
174,Alen Avidzba,Hard,1,1,2,2,50.0
175,Alessandro De Minicis,Clay,9,14,23,23,39.13
176,Alessandro Giannessi,Clay,10,13,23,31,43.48
177,Alessandro Giannessi,Hard,2,6,8,31,25.0
178,Alessio Di Mauro,Clay,15,31,46,53,32.61
179,Alessio Di Mauro,Grass,1,2,3,53,33.33
180,Alessio Di Mauro,Hard,1,3,4,53,25.0
181,Alex Antonitsch,Carpet,19,35,54,251,35.19
182,Alex Antonitsch,Clay,19,30,49,251,38.78
183,Alex Antonitsch,Grass,18,17,35,251,51.43
184,Alex Antonitsch,Hard,51,62,113,251,45.13
185,Alex Bogdanovic,Clay,1,3,4,47,25.0
186,Alex Bogdanovic,Grass,9,26,35,47,25.71
187,Alex Bogdanovic,Hard,1,7,8,47,12.5
188,Alex Bogomolov Jr,Clay,2,12,14,178,14.29
189,Alex Bogomolov Jr,Grass,11,14,25,178,44.0
190,Alex Bogomolov Jr,Hard,57,82,139,178,41.01
191,Alex Bolt,Grass,1,4,5,29,20.0
192,Alex Bolt,Hard,9,15,24,29,37.5
193,Alex Calatrava,Clay,46,68,114,175,40.35
194,Alex Calatrava,Grass,1,6,7,175,14.29
195,Alex Calatrava,Hard,22,32,54,175,40.74
196,Alex Corretja,Carpet,10,24,34,723,29.41
197,Alex Corretja,Clay,292,149,441,723,66.21
198,Alex Corretja,Grass,4,7,11,723,36.36
199,Alex Corretja,Hard,133,104,237,723,56.12
200,Alex De Minaur,Clay,2,11,13,149,15.38
201,Alex De Minaur,Grass,4,6,10,149,40.0
202,Alex De Minaur,Hard,83,43,126,149,65.87
203,Alex Diaz,Hard,2,2,4,4,50.0
204,Alex Kim,Grass,1,2,3,30,33.33
205,Alex Kim,Hard,7,20,27,30,25.93
206,Alex Kurucz,Clay,2,10,12,12,16.67
207,Alex Kuznetsov,Clay,1,2,3,39,33.33
208,Alex Kuznetsov,Grass,2,6,8,39,25.0
209,Alex Kuznetsov,Hard,6,22,28,39,21.43
210,Alex Llompart,Hard,6,5,11,11,54.55
211,Alex Lopez Moron,Clay,18,31,49,49,36.73
212,Alex Mayer,Carpet,8,2,10,23,80.0
213,Alex Mayer,Hard,10,3,13,23,76.92
214,Alex Metreveli,Carpet,34,26,60,327,56.67
215,Alex Metreveli,Clay,60,35,95,327,63.16
216,Alex Metreveli,Grass,92,25,117,327,78.63
217,Alex Metreveli,Hard,40,15,55,327,72.73
218,Alex Obrien,Carpet,8,13,21,230,38.1
219,Alex Obrien,Clay,10,21,31,230,32.26
220,Alex Obrien,Grass,13,18,31,230,41.94
221,Alex Obrien,Hard,63,84,147,230,42.86
222,Alex Radulescu,Carpet,7,12,19,96,36.84
223,Alex Radulescu,Clay,1,7,8,96,12.5
224,Alex Radulescu,Grass,10,9,19,96,52.63
225,Alex Radulescu,Hard,22,28,50,96,44.0
226,Alex Stepanek,Clay,2,9,11,11,18.18
227,Alexandar Lazarov,Hard,2,4,6,6,33.33
228,Alexandar Lazov,Hard,1,4,5,5,20.0
229,Alexander Blom,Clay,3,5,8,17,37.5
230,Alexander Blom,Hard,4,5,9,17,44.44
231,Alexander Bublik,Clay,5,6,11,88,45.45
232,Alexander Bublik,Grass,4,4,8,88,50.0
233,Alexander Bublik,Hard,35,34,69,88,50.72
234,Alexander Donski,Hard,1,1,2,2,50.0
235,Alexander Kudryavtsev,Hard,5,12,17,17,29.41
236,Alexander Lehnhoff,Hard,1,3,4,4,25.0
237,Alexander Marcial,Clay,2,4,6,10,33.33
238,Alexander Marcial,Hard,1,3,4,10,25.0
239,Alexander Mronz,Carpet,18,24,42,169,42.86
240,Alexander Mronz,Clay,7,17,24,169,29.17
241,Alexander Mronz,Grass,4,7,11,169,36.36
242,Alexander Mronz,Hard,33,59,92,169,35.87
243,Alexander Peya,Carpet,3,4,7,73,42.86
244,Alexander Peya,Clay,7,17,24,73,29.17
245,Alexander Peya,Grass,4,15,19,73,21.05
246,Alexander Peya,Hard,8,15,23,73,34.78
247,Alexander Popp,Carpet,1,4,5,110,20.0
248,Alexander Popp,Clay,5,21,26,110,19.23
249,Alexander Popp,Grass,24,14,38,110,63.16
250,Alexander Popp,Hard,15,26,41,110,36.59
251,Alexander Reichel,Grass,1,1,2,8,50.0
252,Alexander Reichel,Hard,2,4,6,8,33.33
253,Alexander Sadecky,Clay,1,2,3,3,33.33
254,Alexander Sarkissian,Hard,2,3,5,5,40.0
255,Alexander Shvec,Carpet,6,3,9,20,66.67
256,Alexander Shvec,Clay,1,5,6,20,16.67
257,Alexander Shvec,Hard,2,3,5,20,40.0
258,Alexander Skrypko,Carpet,1,2,3,3,33.33
259,Alexander Tabares,Clay,1,1,2,2,50.0
260,Alexander Volkov,Carpet,103,75,178,562,57.87
261,Alexander Volkov,Clay,38,57,95,562,40.0
262,Alexander Volkov,Grass,39,28,67,562,58.21
263,Alexander Volkov,Hard,125,97,222,562,56.31
264,Alexander Waske,Carpet,3,4,7,92,42.86
265,Alexander Waske,Clay,15,29,44,92,34.09
266,Alexander Waske,Grass,4,11,15,92,26.67
267,Alexander Waske,Hard,6,20,26,92,23.08
268,Alexander Zverev,Clay,77,33,110,378,70.0
269,Alexander Zverev,Grass,24,14,38,378,63.16
270,Alexander Zverev,Hard,150,80,230,378,65.22
271,Alexander Zverev Sr,Clay,11,8,19,19,57.89
272,Alexandr Dolgopolov,Clay,62,64,126,423,49.21
273,Alexandr Dolgopolov,Grass,23,20,43,423,53.49
274,Alexandr Dolgopolov,Hard,135,119,254,423,53.15
275,Alexandre Hocevar,Grass,1,1,2,11,50.0
276,Alexandre Hocevar,Hard,4,5,9,11,44.44
277,Alexandre Muller,Hard,1,2,3,3,33.33
278,Alexandre Sidorenko,Clay,2,5,7,13,28.57
279,Alexandre Sidorenko,Hard,2,4,6,13,33.33
280,Alexandre Simoni,Clay,4,9,13,33,30.77
281,Alexandre Simoni,Grass,1,4,5,33,20.0
282,Alexandre Simoni,Hard,5,10,15,33,33.33
283,Alexandre Strambini,Clay,1,2,3,3,33.33
284,Alexandros Jakupovic,Clay,5,7,12,12,41.67
285,Alexei Popyrin,Clay,1,4,5,53,20.0
286,Alexei Popyrin,Grass,1,2,3,53,33.33
287,Alexei Popyrin,Hard,21,24,45,53,46.67
288,Alexey Kedryuk,Carpet,1,2,3,34,33.33
289,Alexey Kedryuk,Clay,3,1,4,34,75.0
290,Alexey Kedryuk,Hard,18,9,27,34,66.67
291,Alexey Vatutin,Clay,2,3,5,5,40.0
292,Alexis Hombrecher,Hard,3,3,6,6,50.0
293,Alfred Schwartz,Hard,1,1,2,2,50.0
294,Alfredo Vaz Pinto,Clay,3,10,13,13,23.08
295,Ali Hamadeh,Grass,1,1,2,19,50.0
296,Ali Hamadeh,Hard,11,6,17,19,64.71
297,Ali Kadhim,Hard,2,2,4,4,50.0
298,Ali Madani,Clay,1,5,6,6,16.67
299,Alistair Hunt,Carpet,3,2,5,29,60.0
300,Alistair Hunt,Clay,1,3,4,29,25.0
301,Alistair Hunt,Grass,2,1,3,29,66.67
302,Alistair Hunt,Hard,6,11,17,29,35.29
303,Aljaz Bedene,Clay,53,53,106,261,50.0
304,Aljaz Bedene,Grass,11,17,28,261,39.29
305,Aljaz Bedene,Hard,58,69,127,261,45.67
306,Alkis Papamichael,Clay,1,13,14,14,7.14
307,Allan McDonald,Clay,2,10,12,31,16.67
308,Allan McDonald,Grass,5,14,19,31,26.32
309,Allan Stone,Carpet,27,50,77,414,35.06
310,Allan Stone,Clay,50,50,100,414,50.0
311,Allan Stone,Grass,72,57,129,414,55.81
312,Allan Stone,Hard,49,59,108,414,45.37
313,Allen Belobrajdic,Hard,1,4,5,5,20.0
314,Alphonso Ochoa,Clay,2,1,3,3,66.67
315,Alti Vahkal,Carpet,2,3,5,5,40.0
316,Altug Celikbilek,Clay,1,1,2,12,50.0
317,Altug Celikbilek,Grass,1,1,2,12,50.0
318,Altug Celikbilek,Hard,4,4,8,12,50.0
319,Alun Jones,Hard,4,9,13,13,30.77
320,Alvaro Betancur,Clay,32,67,99,108,32.32
321,Alvaro Betancur,Hard,1,8,9,108,11.11
322,Alvaro Fillol,Carpet,5,12,17,117,29.41
323,Alvaro Fillol,Clay,19,57,76,117,25.0
324,Alvaro Fillol,Grass,1,4,5,117,20.0
325,Alvaro Fillol,Hard,8,11,19,117,42.11
326,Alvaro Jordan,Clay,11,10,21,33,52.38
327,Alvaro Jordan,Hard,10,2,12,33,83.33
328,Alvaro Pena,Clay,1,2,3,3,33.33
329,Alvin Gardiner,Carpet,3,4,7,116,42.86
330,Alvin Gardiner,Clay,11,30,41,116,26.83
331,Alvin Gardiner,Grass,6,29,35,116,17.14
332,Alvin Gardiner,Hard,10,23,33,116,30.3
333,Aly El Dawoudi,Clay,6,4,10,13,60.0
334,Aly El Dawoudi,Hard,1,2,3,13,33.33
335,Amer Delic,Clay,2,8,10,89,20.0
336,Amer Delic,Grass,2,6,8,89,25.0
337,Amer Delic,Hard,29,42,71,89,40.85
338,Americo Venero Montes,Clay,2,6,8,15,25.0
339,Americo Venero Montes,Hard,5,2,7,15,71.43
340,Amine Ahouda,Clay,2,4,6,6,33.33
341,Amir Hadad,Clay,2,3,5,14,40.0
342,Amir Hadad,Hard,4,5,9,14,44.44
343,Amir Weintraub,Clay,3,2,5,22,60.0
344,Amir Weintraub,Hard,7,10,17,22,41.18
345,Amit Naor,Hard,3,7,10,10,30.0
346,Amos Mansdorf,Carpet,50,46,96,542,52.08
347,Amos Mansdorf,Clay,13,35,48,542,27.08
348,Amos Mansdorf,Grass,35,26,61,542,57.38
349,Amos Mansdorf,Hard,211,126,337,542,62.61
350,Amro Ghoneim,Clay,12,15,27,27,44.44
351,Anand Amritraj,Carpet,10,34,44,258,22.73
352,Anand Amritraj,Clay,32,57,89,258,35.96
353,Anand Amritraj,Grass,17,27,44,258,38.64
354,Anand Amritraj,Hard,29,52,81,258,35.8
355,Anatoli Volkov,Clay,2,6,8,8,25.0
356,Anders Haseth,Carpet,6,3,9,16,66.67
357,Anders Haseth,Clay,3,4,7,16,42.86
358,Anders Jarryd,Carpet,152,74,226,658,67.26
359,Anders Jarryd,Clay,92,68,160,658,57.5
360,Anders Jarryd,Grass,35,30,65,658,53.85
361,Anders Jarryd,Hard,118,89,207,658,57.0
362,Andis Juska,Carpet,8,5,13,39,61.54
363,Andis Juska,Clay,10,10,20,39,50.0
364,Andis Juska,Hard,1,5,6,39,16.67
365,Andras Lanyi,Clay,3,5,8,12,37.5
366,Andras Lanyi,Hard,2,2,4,12,50.0
367,Andras Szikszai,Clay,1,2,3,3,33.33
368,Andre Agassi,Carpet,72,40,112,1147,64.29
369,Andre Agassi,Clay,152,57,209,1147,72.73
370,Andre Agassi,Grass,50,18,68,1147,73.53
371,Andre Agassi,Hard,598,160,758,1147,78.89
372,Andre Ghem,Clay,2,5,7,7,28.57
373,Andre Sa,Carpet,4,7,11,144,36.36
374,Andre Sa,Clay,12,31,43,144,27.91
375,Andre Sa,Grass,10,17,27,144,37.04
376,Andre Sa,Hard,26,37,63,144,41.27
377,Andre Zietsmann,Hard,2,7,9,9,22.22
378,Andrea Arnaboldi,Clay,4,8,12,12,33.33
379,Andrea Gaudenzi,Carpet,10,20,30,451,33.33
380,Andrea Gaudenzi,Clay,167,132,299,451,55.85
381,Andrea Gaudenzi,Grass,1,9,10,451,10.0
382,Andrea Gaudenzi,Hard,42,70,112,451,37.5
383,Andrea Pellegrino,Clay,1,1,2,2,50.0
384,Andrea Stoppini,Hard,3,6,9,9,33.33
385,Andreas Beck,Clay,20,35,55,107,36.36
386,Andreas Beck,Grass,7,7,14,107,50.0
387,Andreas Beck,Hard,14,24,38,107,36.84
388,Andreas Fikas,Clay,4,1,5,5,80.0
389,Andreas Haider Maurer,Clay,24,38,62,124,38.71
390,Andreas Haider Maurer,Grass,4,10,14,124,28.57
391,Andreas Haider Maurer,Hard,17,31,48,124,35.42
392,Andreas Lesch,Clay,1,2,3,3,33.33
393,Andreas Maurer,Carpet,2,14,16,260,12.5
394,Andreas Maurer,Clay,90,99,189,260,47.62
395,Andreas Maurer,Grass,14,14,28,260,50.0
396,Andreas Maurer,Hard,10,17,27,260,37.04
397,Andreas Seppi,Carpet,4,10,14,784,28.57
398,Andreas Seppi,Clay,131,133,264,784,49.62
399,Andreas Seppi,Grass,60,46,106,784,56.6
400,Andreas Seppi,Hard,184,216,400,784,46.0
401,Andreas Vinciguerra,Carpet,6,7,13,190,46.15
402,Andreas Vinciguerra,Clay,31,40,71,190,43.66
403,Andreas Vinciguerra,Grass,2,5,7,190,28.57
404,Andreas Vinciguerra,Hard,48,51,99,190,48.48
405,Andrei Cherkasov,Carpet,47,49,96,398,48.96
406,Andrei Cherkasov,Clay,76,83,159,398,47.8
407,Andrei Cherkasov,Hard,70,73,143,398,48.95
408,Andrei Chesnokov,Carpet,43,51,94,608,45.74
409,Andrei Chesnokov,Clay,170,95,265,608,64.15
410,Andrei Chesnokov,Grass,6,16,22,608,27.27
411,Andrei Chesnokov,Hard,129,98,227,608,56.83
412,Andrei Dirzu,Carpet,2,1,3,21,66.67
413,Andrei Dirzu,Clay,3,9,12,21,25.0
414,Andrei Dirzu,Grass,1,1,2,21,50.0
415,Andrei Dirzu,Hard,1,3,4,21,25.0
416,Andrei Gorban,Carpet,1,1,2,9,50.0
417,Andrei Gorban,Clay,2,5,7,9,28.57
418,Andrei Karatchenia,Hard,3,2,5,5,60.0
419,Andrei Luzgin,Carpet,3,2,5,5,60.0
420,Andrei Medvedev,Carpet,48,44,92,537,52.17
421,Andrei Medvedev,Clay,171,85,256,537,66.8
422,Andrei Medvedev,Grass,16,18,34,537,47.06
423,Andrei Medvedev,Hard,87,68,155,537,56.13
424,Andrei Merinov,Carpet,3,2,5,16,60.0
425,Andrei Merinov,Clay,1,5,6,16,16.67
426,Andrei Merinov,Hard,2,3,5,16,40.0
427,Andrei Olhovskiy,Carpet,49,45,94,283,52.13
428,Andrei Olhovskiy,Clay,16,36,52,283,30.77
429,Andrei Olhovskiy,Grass,23,23,46,283,50.0
430,Andrei Olhovskiy,Hard,30,61,91,283,32.97
431,Andrei Pavel,Carpet,35,32,67,548,52.24
432,Andrei Pavel,Clay,109,91,200,548,54.5
433,Andrei Pavel,Grass,22,27,49,548,44.9
434,Andrei Pavel,Hard,115,117,232,548,49.57
435,Andrei Rybalko,Carpet,3,8,11,22,27.27
436,Andrei Rybalko,Clay,3,8,11,22,27.27
437,Andrei Stoliarov,Carpet,2,6,8,95,25.0
438,Andrei Stoliarov,Clay,9,15,24,95,37.5
439,Andrei Stoliarov,Grass,6,11,17,95,35.29
440,Andrei Stoliarov,Hard,20,26,46,95,43.48
441,Andrei Vasilevski,Hard,1,4,5,5,20.0
442,Andrej Kracman,Carpet,1,2,3,15,33.33
443,Andrej Kracman,Clay,6,3,9,15,66.67
444,Andrej Kracman,Hard,2,1,3,15,66.67
445,Andrej Krasevec,Clay,1,1,2,2,50.0
446,Andrej Martin,Clay,17,18,35,49,48.57
447,Andrej Martin,Hard,3,11,14,49,21.43
448,Andres Alarcon,Hard,1,1,2,2,50.0
449,Andres Battad,Clay,2,5,7,7,28.57
450,Andres Filimonov,Carpet,3,2,5,17,60.0
451,Andres Filimonov,Clay,6,6,12,17,50.0
452,Andres Gimeno,Carpet,21,18,39,291,53.85
453,Andres Gimeno,Clay,80,32,112,291,71.43
454,Andres Gimeno,Grass,45,18,63,291,71.43
455,Andres Gimeno,Hard,47,30,77,291,61.04
456,Andres Gomez,Carpet,60,53,113,806,53.1
457,Andres Gomez,Clay,330,140,470,806,70.21
458,Andres Gomez,Grass,10,8,18,806,55.56
459,Andres Gomez,Hard,132,73,205,806,64.39
460,Andres Vysand,Carpet,1,3,4,35,25.0
461,Andres Vysand,Clay,10,21,31,35,32.26
462,Andrew Burrow,Clay,1,3,4,11,25.0
463,Andrew Burrow,Hard,2,5,7,11,28.57
464,Andrew Castle,Clay,2,6,8,74,25.0
465,Andrew Castle,Grass,8,21,29,74,27.59
466,Andrew Castle,Hard,12,25,37,74,32.43
467,Andrew Foster,Grass,4,5,9,9,44.44
468,Andrew Harris,Hard,1,2,3,3,33.33
469,Andrew Ilie,Carpet,1,5,6,206,16.67
470,Andrew Ilie,Clay,42,37,79,206,53.16
471,Andrew Ilie,Grass,5,11,16,206,31.25
472,Andrew Ilie,Hard,41,64,105,206,39.05
473,Andrew Jarrett,Carpet,1,4,5,54,20.0
474,Andrew Jarrett,Clay,7,14,21,54,33.33
475,Andrew Jarrett,Grass,3,15,18,54,16.67
476,Andrew Jarrett,Hard,4,6,10,54,40.0
477,Andrew Pattison,Carpet,69,77,146,537,47.26
478,Andrew Pattison,Clay,66,61,127,537,51.97
479,Andrew Pattison,Grass,35,33,68,537,51.47
480,Andrew Pattison,Hard,110,86,196,537,56.12
481,Andrew Rae,Hard,1,1,2,2,50.0
482,Andrew Richardson,Carpet,2,4,6,20,33.33
483,Andrew Richardson,Grass,3,7,10,20,30.0
484,Andrew Richardson,Hard,1,3,4,20,25.0
485,Andrew Sznajder,Carpet,13,10,23,131,56.52
486,Andrew Sznajder,Clay,12,18,30,131,40.0
487,Andrew Sznajder,Hard,33,45,78,131,42.31
488,Andrew Whittington,Hard,2,2,4,4,50.0
489,Andrey Dernovskiy,Carpet,1,2,3,10,33.33
490,Andrey Dernovskiy,Clay,1,6,7,10,14.29
491,Andrey Golubev,Clay,22,39,61,181,36.07
492,Andrey Golubev,Grass,1,10,11,181,9.09
493,Andrey Golubev,Hard,42,67,109,181,38.53
494,Andrey Kuznetsov,Clay,30,37,67,177,44.78
495,Andrey Kuznetsov,Grass,7,13,20,177,35.0
496,Andrey Kuznetsov,Hard,42,48,90,177,46.67
497,Andrey Rublev,Clay,25,18,43,225,58.14
498,Andrey Rublev,Grass,4,3,7,225,57.14
499,Andrey Rublev,Hard,108,67,175,225,61.71
500,Andrian Raturandang,Hard,2,9,11,11,18.18
501,Andrzej Licis,Clay,1,2,3,3,33.33
502,Andy Andrews,Carpet,6,6,12,56,50.0
503,Andy Andrews,Clay,4,7,11,56,36.36
504,Andy Andrews,Grass,7,13,20,56,35.0
505,Andy Andrews,Hard,1,12,13,56,7.69
506,Andy Kohlberg,Carpet,4,7,11,50,36.36
507,Andy Kohlberg,Clay,1,9,10,50,10.0
508,Andy Kohlberg,Grass,1,2,3,50,33.33
509,Andy Kohlberg,Hard,7,19,26,50,26.92
510,Andy Murray,Carpet,8,3,11,889,72.73
511,Andy Murray,Clay,106,48,154,889,68.83
512,Andy Murray,Grass,108,22,130,889,83.08
513,Andy Murray,Hard,461,133,594,889,77.61
514,Andy Ram,Carpet,1,1,2,15,50.0
515,Andy Ram,Clay,1,2,3,15,33.33
516,Andy Ram,Hard,2,8,10,15,20.0
517,Andy Roddick,Carpet,25,10,35,827,71.43
518,Andy Roddick,Clay,76,43,119,827,63.87
519,Andy Roddick,Grass,87,22,109,827,79.82
520,Andy Roddick,Hard,424,140,564,827,75.18
521,Andy Zingman,Clay,1,2,3,3,33.33
522,Angel Gimenez,Carpet,1,7,8,195,12.5
523,Angel Gimenez,Clay,79,85,164,195,48.17
524,Angel Gimenez,Grass,1,5,6,195,16.67
525,Angel Gimenez,Hard,6,11,17,195,35.29
526,Anoosha Shahgholi,Carpet,1,1,2,14,50.0
527,Anoosha Shahgholi,Clay,5,7,12,14,41.67
528,Ante Pavic,Grass,2,4,6,12,33.33
529,Ante Pavic,Hard,1,5,6,12,16.67
530,Anthony Billington,Grass,1,1,2,2,50.0
531,Anthony Bull,Grass,1,1,2,2,50.0
532,Anthony Fawcett,Hard,1,4,5,5,20.0
533,Anthony Hammond,Grass,2,6,8,8,25.0
534,Anthony Lane,Grass,1,3,4,4,25.0
535,Anthony Mills,Hard,1,1,2,2,50.0
536,Antoine Bellier,Clay,1,4,5,5,20.0
537,Antoine Beugre,Carpet,3,1,4,8,75.0
538,Antoine Beugre,Hard,1,3,4,8,25.0
539,Antoine Hoang,Clay,2,2,4,15,50.0
540,Antoine Hoang,Hard,3,8,11,15,27.27
541,Anton Tsymbalov,Clay,1,1,2,2,50.0
542,Antonio Martinez,Clay,1,1,2,2,50.0
543,Antonio Munoz,Carpet,2,6,8,266,25.0
544,Antonio Munoz,Clay,86,133,219,266,39.27
545,Antonio Munoz,Grass,5,13,18,266,27.78
546,Antonio Munoz,Hard,4,17,21,266,19.05
547,Antonio Palafox,Grass,2,4,6,6,33.33
548,Antonio Solana,Clay,1,1,2,2,50.0
549,Antonio Veic,Clay,5,14,19,35,26.32
550,Antonio Veic,Hard,6,10,16,35,37.5
551,Antonio Zugarelli,Carpet,14,29,43,266,32.56
552,Antonio Zugarelli,Clay,88,93,181,266,48.62
553,Antonio Zugarelli,Grass,4,13,17,266,23.53
554,Antonio Zugarelli,Hard,6,19,25,266,24.0
555,Antony Dupuis,Carpet,6,8,14,214,42.86
556,Antony Dupuis,Clay,20,38,58,214,34.48
557,Antony Dupuis,Grass,19,22,41,214,46.34
558,Antony Dupuis,Hard,41,60,101,214,40.59
559,Antso Rakotondramanga,Clay,2,1,3,5,66.67
560,Antso Rakotondramanga,Hard,1,1,2,5,50.0
561,Aqeel Khan,Clay,8,13,21,66,38.1
562,Aqeel Khan,Grass,10,8,18,66,55.56
563,Aqeel Khan,Hard,10,17,27,66,37.04
564,Arafat Chekrouni,Clay,4,6,10,17,40.0
565,Arafat Chekrouni,Hard,4,3,7,17,57.14
566,Ariel Behar,Hard,1,2,3,3,33.33
567,Arif Kocak,Clay,2,2,4,4,50.0
568,Arjun Fernando,Clay,11,8,19,31,57.89
569,Arjun Fernando,Hard,5,7,12,31,41.67
570,Armand Molino,Clay,1,1,2,4,50.0
571,Armand Molino,Hard,1,1,2,4,50.0
572,Armand Strombach,Carpet,1,1,2,9,50.0
573,Armand Strombach,Clay,2,2,4,9,50.0
574,Armand Strombach,Hard,1,2,3,9,33.33
575,Armando Cornejo,Clay,3,7,10,10,30.0
576,Armando Perez,Clay,3,2,5,5,60.0
577,Armistead Neely,Clay,7,15,22,50,31.82
578,Armistead Neely,Grass,8,11,19,50,42.11
579,Armistead Neely,Hard,1,8,9,50,11.11
580,Arnau Brugues Davi,Hard,1,2,3,3,33.33
581,Arnaud Boetsch,Carpet,70,52,122,437,57.38
582,Arnaud Boetsch,Clay,58,64,122,437,47.54
583,Arnaud Boetsch,Grass,19,16,35,437,54.29
584,Arnaud Boetsch,Hard,85,73,158,437,53.8
585,Arnaud Clement,Carpet,41,41,82,646,50.0
586,Arnaud Clement,Clay,49,71,120,646,40.83
587,Arnaud Clement,Grass,50,43,93,646,53.76
588,Arnaud Clement,Hard,178,173,351,646,50.71
589,Arnaud Di Pasquale,Carpet,3,6,9,167,33.33
590,Arnaud Di Pasquale,Clay,47,52,99,167,47.47
591,Arnaud Di Pasquale,Grass,1,3,4,167,25.0
592,Arnaud Di Pasquale,Hard,18,37,55,167,32.73
593,Arne Thoms,Carpet,7,10,17,58,41.18
594,Arne Thoms,Clay,1,5,6,58,16.67
595,Arne Thoms,Grass,12,11,23,58,52.17
596,Arne Thoms,Hard,3,9,12,58,25.0
597,Artem Sitak,Clay,1,1,2,11,50.0
598,Artem Sitak,Grass,1,1,2,11,50.0
599,Artem Sitak,Hard,4,3,7,11,57.14
600,Artem Smirnov,Hard,2,3,5,5,40.0
601,Arthur Anastopoulo,Hard,1,1,2,2,50.0
602,Arthur Ashe,Carpet,251,71,322,927,77.95
603,Arthur Ashe,Clay,160,66,226,927,70.8
604,Arthur Ashe,Grass,110,34,144,927,76.39
605,Arthur Ashe,Hard,179,56,235,927,76.17
606,Arthur De Greef,Clay,2,5,7,10,28.57
607,Arthur De Greef,Hard,1,2,3,10,33.33
608,Arvind Parmar,Carpet,1,3,4,45,25.0
609,Arvind Parmar,Grass,11,18,29,45,37.93
610,Arvind Parmar,Hard,3,9,12,45,25.0
611,Ashkan Shokoofi,Carpet,1,1,2,13,50.0
612,Ashkan Shokoofi,Clay,5,4,9,13,55.56
613,Ashkan Shokoofi,Hard,1,1,2,13,50.0
614,Ashley Cooper,Clay,1,1,2,2,50.0
615,Ashley Hewitt,Hard,3,1,4,4,75.0
616,Ashok Amritraj,Carpet,1,4,5,22,20.0
617,Ashok Amritraj,Clay,3,14,17,22,17.65
618,Asif Ismail,Hard,1,1,2,2,50.0
619,Asim Shafik,Clay,3,1,4,13,75.0
620,Asim Shafik,Hard,3,6,9,13,33.33
621,Asiri Iddamalgoda,Hard,1,1,2,2,50.0
622,Aslan Karatsev,Hard,8,11,19,19,42.11
623,Atet Wijono,Clay,4,5,9,9,44.44
624,Athanasios Anastopoulos,Clay,2,1,3,3,66.67
625,Attila Balazs,Carpet,1,3,4,51,25.0
626,Attila Balazs,Clay,24,13,37,51,64.86
627,Attila Balazs,Hard,3,7,10,51,30.0
628,Attila Korpas,Clay,26,39,65,69,40.0
629,Attila Korpas,Hard,2,2,4,69,50.0
630,Attila Savolt,Carpet,2,7,9,99,22.22
631,Attila Savolt,Clay,34,30,64,99,53.12
632,Attila Savolt,Hard,6,20,26,99,23.08
633,Augustin Gensse,Clay,1,2,3,3,33.33
634,Austin Krajicek,Grass,1,4,5,34,20.0
635,Austin Krajicek,Hard,11,18,29,34,37.93
636,Axel Finnberg,Hard,1,4,5,5,20.0
637,Axel Michon,Clay,1,1,2,2,50.0
638,Axel Pretzsch,Hard,11,18,29,29,37.93
639,B Johnston,Hard,1,1,2,2,50.0
640,B Moreau,Clay,1,2,3,3,33.33
641,B Newman,Hard,1,1,2,2,50.0
642,Bader Mohammed Almuqail,Hard,3,6,9,9,33.33
643,Bailey Brown,Carpet,2,1,3,3,66.67
644,Balazs Taroczy,Carpet,41,46,87,644,47.13
645,Balazs Taroczy,Clay,316,139,455,644,69.45
646,Balazs Taroczy,Grass,14,13,27,644,51.85
647,Balazs Taroczy,Hard,39,36,75,644,52.0
648,Balazs Veress,Hard,1,1,2,2,50.0
649,Baris Ergun,Hard,2,1,3,3,66.67
650,Barry Cowan,Grass,3,13,16,24,18.75
651,Barry Cowan,Hard,2,6,8,24,25.0
652,Barry King,Hard,1,2,3,3,33.33
653,Barry Mackay,Clay,4,8,12,29,33.33
654,Barry Mackay,Grass,1,3,4,29,25.0
655,Barry Mackay,Hard,5,8,13,29,38.46
656,Barry Moir,Clay,11,13,24,92,45.83
657,Barry Moir,Grass,5,8,13,92,38.46
658,Barry Moir,Hard,20,35,55,92,36.36
659,Barry Phillips Moore,Carpet,11,30,41,408,26.83
660,Barry Phillips Moore,Clay,126,110,236,408,53.39
661,Barry Phillips Moore,Grass,30,37,67,408,44.78
662,Barry Phillips Moore,Hard,22,42,64,408,34.38
663,Bart Wuyts,Carpet,3,17,20,115,15.0
664,Bart Wuyts,Clay,38,36,74,115,51.35
665,Bart Wuyts,Hard,7,14,21,115,33.33
666,Bartlomiej Dabrowski,Carpet,4,5,9,44,44.44
667,Bartlomiej Dabrowski,Clay,15,12,27,44,55.56
668,Bartlomiej Dabrowski,Hard,4,4,8,44,50.0
669,Basil Wheeler,Hard,1,1,2,2,50.0
670,Bastian Knittel,Clay,1,3,4,4,25.0
671,Bastian Trinker,Clay,1,2,3,3,33.33
672,Beejong Sisson,Clay,2,4,6,10,33.33
673,Beejong Sisson,Grass,2,2,4,10,50.0
674,Belus Prajoux,Carpet,7,10,17,210,41.18
675,Belus Prajoux,Clay,71,103,174,210,40.8
676,Belus Prajoux,Grass,3,8,11,210,27.27
677,Belus Prajoux,Hard,2,6,8,210,25.0
678,Ben Ellwood,Grass,1,3,4,18,25.0
679,Ben Ellwood,Hard,3,11,14,18,21.43
680,Ben Mckown,Clay,2,5,7,13,28.57
681,Ben Mckown,Hard,2,4,6,13,33.33
682,Ben Qiang Zhu,Grass,2,2,4,30,50.0
683,Ben Qiang Zhu,Hard,15,11,26,30,57.69
684,Ben Testerman,Carpet,24,20,44,189,54.55
685,Ben Testerman,Clay,7,12,19,189,36.84
686,Ben Testerman,Grass,21,21,42,189,50.0
687,Ben Testerman,Hard,35,49,84,189,41.67
688,Bengt Lundstedt,Carpet,1,2,3,3,33.33
689,Benjamin Balleret,Carpet,1,2,3,53,33.33
690,Benjamin Balleret,Clay,22,16,38,53,57.89
691,Benjamin Balleret,Hard,5,7,12,53,41.67
692,Benjamin Becker,Carpet,1,2,3,375,33.33
693,Benjamin Becker,Clay,11,34,45,375,24.44
694,Benjamin Becker,Grass,36,30,66,375,54.55
695,Benjamin Becker,Hard,106,155,261,375,40.61
696,Benjamin Bonzi,Clay,2,2,4,8,50.0
697,Benjamin Bonzi,Hard,2,2,4,8,50.0
698,Benjamin Hassan,Hard,4,1,5,5,80.0
699,Benjamin Lock,Hard,8,2,10,10,80.0
700,Benoit Paire,Clay,81,76,157,468,51.59
701,Benoit Paire,Grass,23,23,46,468,50.0
702,Benoit Paire,Hard,121,144,265,468,45.66
703,Bent Ove Pedersen,Carpet,6,2,8,21,75.0
704,Bent Ove Pedersen,Clay,3,3,6,21,50.0
705,Bent Ove Pedersen,Hard,4,3,7,21,57.14
706,Bernabe Zapata Miralles,Clay,1,3,4,4,25.0
707,Bernard Balleret,Carpet,1,1,2,39,50.0
708,Bernard Balleret,Clay,12,18,30,39,40.0
709,Bernard Balleret,Hard,2,5,7,39,28.57
710,Bernard Boileau,Carpet,3,5,8,94,37.5
711,Bernard Boileau,Clay,28,31,59,94,47.46
712,Bernard Boileau,Grass,1,3,4,94,25.0
713,Bernard Boileau,Hard,10,13,23,94,43.48
714,Bernard Fritz,Carpet,2,5,7,135,28.57
715,Bernard Fritz,Clay,38,58,96,135,39.58
716,Bernard Fritz,Grass,2,2,4,135,50.0
717,Bernard Fritz,Hard,11,17,28,135,39.29
718,Bernard Mignot,Carpet,3,3,6,101,50.0
719,Bernard Mignot,Clay,30,42,72,101,41.67
720,Bernard Mignot,Grass,3,4,7,101,42.86
721,Bernard Mignot,Hard,10,6,16,101,62.5
722,Bernard Mitton,Carpet,51,62,113,422,45.13
723,Bernard Mitton,Clay,32,50,82,422,39.02
724,Bernard Mitton,Grass,36,34,70,422,51.43
725,Bernard Mitton,Hard,80,77,157,422,50.96
726,Bernard Montrenaud,Clay,6,15,21,21,28.57
727,Bernard Paul,Carpet,1,3,4,17,25.0
728,Bernard Paul,Clay,3,10,13,17,23.08
729,Bernard Pinto,Clay,1,2,3,3,33.33
730,Bernard Tomic,Clay,21,44,65,371,32.31
731,Bernard Tomic,Grass,38,32,70,371,54.29
732,Bernard Tomic,Hard,127,109,236,371,53.81
733,Bernardo Mota,Carpet,3,4,7,34,42.86
734,Bernardo Mota,Clay,11,16,27,34,40.74
735,Bernd Karbacher,Carpet,3,15,18,297,16.67
736,Bernd Karbacher,Clay,77,68,145,297,53.1
737,Bernd Karbacher,Grass,4,13,17,297,23.53
738,Bernd Karbacher,Hard,52,65,117,297,44.44
739,Bernd Kube,Clay,1,5,6,6,16.67
740,Bernhard Pils,Carpet,1,3,4,45,25.0
741,Bernhard Pils,Clay,9,19,28,45,32.14
742,Bernhard Pils,Grass,1,1,2,45,50.0
743,Bernhard Pils,Hard,4,7,11,45,36.36
744,Berry Geraghty,Grass,1,2,3,3,33.33
745,Bertalan Csoknyai,Clay,1,1,2,2,50.0
746,Bertrand Lacombe,Hard,2,2,4,4,50.0
747,Bertrand Madsen,Clay,6,13,19,26,31.58
748,Bertrand Madsen,Hard,3,4,7,26,42.86
749,Bhanu Nunna,Carpet,1,1,2,2,50.0
750,Bidynt Goswami,Clay,1,2,3,3,33.33
751,Bill Barber,Hard,1,1,2,2,50.0
752,Bill Behrens,Clay,2,4,6,6,33.33
753,Bill Bowrey,Clay,25,28,53,155,47.17
754,Bill Bowrey,Grass,44,30,74,155,59.46
755,Bill Bowrey,Hard,11,17,28,155,39.29
756,Bill Brown,Grass,1,1,2,2,50.0
757,Bill Colson,Grass,1,2,3,3,33.33
758,Bill Cowan,Hard,2,6,8,8,25.0
759,Bill Freer,Clay,2,4,6,23,33.33
760,Bill Freer,Grass,2,3,5,23,40.0
761,Bill Freer,Hard,3,9,12,23,25.0
762,Bill Gilmour,Grass,1,1,2,2,50.0
763,Bill Lloyd,Clay,5,18,23,53,21.74
764,Bill Lloyd,Grass,7,13,20,53,35.0
765,Bill Lloyd,Hard,2,8,10,53,20.0
766,Bill Lofgren,Clay,1,9,10,24,10.0
767,Bill Lofgren,Grass,2,9,11,24,18.18
768,Bill Lofgren,Hard,1,2,3,24,33.33
769,Bill Maze,Carpet,2,8,10,44,20.0
770,Bill Maze,Clay,1,6,7,44,14.29
771,Bill Maze,Grass,4,8,12,44,33.33
772,Bill Maze,Hard,5,10,15,44,33.33
773,Bill Monan,Clay,1,3,4,4,25.0
774,Bill Scanlon,Carpet,102,85,187,560,54.55
775,Bill Scanlon,Clay,34,47,81,560,41.98
776,Bill Scanlon,Grass,59,41,100,560,59.0
777,Bill Scanlon,Hard,107,85,192,560,55.73
778,Billy Martin,Carpet,45,53,98,312,45.92
779,Billy Martin,Clay,41,51,92,312,44.57
780,Billy Martin,Grass,20,23,43,312,46.51
781,Billy Martin,Hard,35,44,79,312,44.3
782,Billy Nealon,Clay,1,8,9,9,11.11
783,Bing Chao Lin,Carpet,1,1,2,30,50.0
784,Bing Chao Lin,Clay,6,7,13,30,46.15
785,Bing Chao Lin,Hard,8,7,15,30,53.33
786,Bing Pan,Carpet,1,10,11,37,9.09
787,Bing Pan,Clay,5,1,6,37,83.33
788,Bing Pan,Grass,1,1,2,37,50.0
789,Bing Pan,Hard,9,9,18,37,50.0
790,Birger Andersson,Carpet,2,7,9,104,22.22
791,Birger Andersson,Clay,28,48,76,104,36.84
792,Birger Andersson,Grass,2,2,4,104,50.0
793,Birger Andersson,Hard,4,11,15,104,26.67
794,Bjorn Borg,Carpet,178,42,220,782,80.91
795,Bjorn Borg,Clay,279,48,327,782,85.32
796,Bjorn Borg,Grass,72,13,85,782,84.71
797,Bjorn Borg,Hard,113,37,150,782,75.33
798,Bjorn Fratangelo,Clay,5,9,14,55,35.71
799,Bjorn Fratangelo,Grass,3,3,6,55,50.0
800,Bjorn Fratangelo,Hard,12,23,35,55,34.29
801,Bjorn Phau,Carpet,1,4,5,218,20.0
802,Bjorn Phau,Clay,22,37,59,218,37.29
803,Bjorn Phau,Grass,1,13,14,218,7.14
804,Bjorn Phau,Hard,56,84,140,218,40.0
805,Bjorn Rehnquist,Clay,3,4,7,15,42.86
806,Bjorn Rehnquist,Hard,1,7,8,15,12.5
807,Blaine Willenborg,Carpet,2,3,5,87,40.0
808,Blaine Willenborg,Clay,23,35,58,87,39.66
809,Blaine Willenborg,Hard,8,16,24,87,33.33
810,Blaise Bicknell,Hard,1,1,2,2,50.0
811,Blaz Kavcic,Carpet,2,1,3,145,66.67
812,Blaz Kavcic,Clay,26,34,60,145,43.33
813,Blaz Kavcic,Grass,3,13,16,145,18.75
814,Blaz Kavcic,Hard,24,42,66,145,36.36
815,Blaz Rola,Clay,8,9,17,34,47.06
816,Blaz Rola,Grass,1,4,5,34,20.0
817,Blaz Rola,Hard,4,8,12,34,33.33
818,Blaz Trupej,Clay,2,4,6,8,33.33
819,Blaz Trupej,Hard,1,1,2,8,50.0
820,Bo Holmstrom,Hard,2,4,6,6,33.33
821,Boaz Merenstein,Hard,2,4,6,6,33.33
822,Bob Blazekovic,Carpet,1,1,2,2,50.0
823,Bob Bryan,Clay,3,5,8,60,37.5
824,Bob Bryan,Grass,8,6,14,60,57.14
825,Bob Bryan,Hard,10,28,38,60,26.32
826,Bob Carmichael,Carpet,17,43,60,427,28.33
827,Bob Carmichael,Clay,64,72,136,427,47.06
828,Bob Carmichael,Grass,46,49,95,427,48.42
829,Bob Carmichael,Hard,67,69,136,427,49.26
830,Bob Giltinan,Carpet,8,17,25,178,32.0
831,Bob Giltinan,Clay,8,17,25,178,32.0
832,Bob Giltinan,Grass,52,44,96,178,54.17
833,Bob Giltinan,Hard,10,22,32,178,31.25
834,Bob Goeltz,Grass,1,2,3,3,33.33
835,Bob Green,Carpet,10,12,22,98,45.45
836,Bob Green,Grass,5,13,18,98,27.78
837,Bob Green,Hard,28,30,58,98,48.28
838,Bob Hewitt,Carpet,32,38,70,377,45.71
839,Bob Hewitt,Clay,89,54,143,377,62.24
840,Bob Hewitt,Grass,44,25,69,377,63.77
841,Bob Hewitt,Hard,54,41,95,377,56.84
842,Bob Howe,Clay,4,10,14,31,28.57
843,Bob Howe,Grass,7,10,17,31,41.18
844,Bob Weise W055,Clay,1,2,3,3,33.33
845,Bobby Banck,Clay,1,1,2,2,50.0
846,Bobby Kokavec,Hard,1,5,6,6,16.67
847,Bobby Reynolds,Clay,3,6,9,101,33.33
848,Bobby Reynolds,Grass,5,12,17,101,29.41
849,Bobby Reynolds,Hard,20,55,75,101,26.67
850,Bobby Webb,Clay,4,7,11,11,36.36
851,Bodo Nitsche,Clay,1,1,2,2,50.0
852,Bohdan Ulihrach,Carpet,30,40,70,478,42.86
853,Bohdan Ulihrach,Clay,116,109,225,478,51.56
854,Bohdan Ulihrach,Grass,5,14,19,478,26.32
855,Bohdan Ulihrach,Hard,79,85,164,478,48.17
856,Bojan Vujic,Carpet,1,1,2,6,50.0
857,Bojan Vujic,Clay,2,2,4,6,50.0
858,Bojidar Pampoulov,Carpet,2,2,4,11,50.0
859,Bojidar Pampoulov,Clay,2,5,7,11,28.57
860,Bong Soo Kim,Carpet,1,6,7,39,14.29
861,Bong Soo Kim,Clay,8,1,9,39,88.89
862,Bong Soo Kim,Grass,1,2,3,39,33.33
863,Bong Soo Kim,Hard,9,11,20,39,45.0
864,Bonit Wiryawan,Clay,2,1,3,7,66.67
865,Bonit Wiryawan,Hard,1,3,4,7,25.0
866,Boris Becker,Carpet,258,67,325,941,79.38
867,Boris Becker,Clay,122,63,185,941,65.95
868,Boris Becker,Grass,116,25,141,941,82.27
869,Boris Becker,Hard,220,70,290,941,75.86
870,Boris Pashanski,Carpet,1,1,2,78,50.0
871,Boris Pashanski,Clay,23,37,60,78,38.33
872,Boris Pashanski,Hard,6,10,16,78,37.5
873,Borna Coric,Clay,54,41,95,305,56.84
874,Borna Coric,Grass,11,10,21,305,52.38
875,Borna Coric,Hard,98,91,189,305,51.85
876,Borna Gojo,Hard,1,4,5,5,20.0
877,Boro Jovanovic,Carpet,1,8,9,112,11.11
878,Boro Jovanovic,Clay,40,50,90,112,44.44
879,Boro Jovanovic,Hard,5,8,13,112,38.46
880,Borut Urh,Clay,6,4,10,10,60.0
881,Bostjan Osabnik,Clay,1,2,3,7,33.33
882,Bostjan Osabnik,Hard,2,2,4,7,50.0
883,Botic van de Zandschulp,Hard,3,3,6,6,50.0
884,Brad Drewett,Carpet,23,30,53,406,43.4
885,Brad Drewett,Clay,25,37,62,406,40.32
886,Brad Drewett,Grass,85,71,156,406,54.49
887,Brad Drewett,Hard,48,87,135,406,35.56
888,Brad Gilbert,Carpet,122,72,194,808,62.89
889,Brad Gilbert,Clay,42,42,84,808,50.0
890,Brad Gilbert,Grass,31,25,56,808,55.36
891,Brad Gilbert,Hard,325,149,474,808,68.57
892,Brad Guan,Clay,2,5,7,22,28.57
893,Brad Guan,Grass,6,9,15,22,40.0
894,Brad Pearce,Carpet,4,11,15,120,26.67
895,Brad Pearce,Clay,3,5,8,120,37.5
896,Brad Pearce,Grass,7,8,15,120,46.67
897,Brad Pearce,Hard,27,55,82,120,32.93
898,Brad Rowe,Clay,1,1,2,5,50.0
899,Brad Rowe,Hard,1,2,3,5,33.33
900,Bradley Klahn,Grass,2,7,9,50,22.22
901,Bradley Klahn,Hard,11,30,41,50,26.83
902,Brandon Nakashima,Hard,3,2,5,5,60.0
903,Branislav Stankovic,Clay,5,12,17,22,29.41
904,Branislav Stankovic,Grass,2,3,5,22,40.0
905,Branko Horvat,Clay,1,1,2,2,50.0
906,Brayden Schnur,Hard,4,12,16,16,25.0
907,Brendan Evans,Grass,4,3,7,21,57.14
908,Brendan Evans,Hard,2,12,14,21,14.29
909,Brent Larkham,Clay,1,5,6,12,16.67
910,Brent Larkham,Grass,1,1,2,12,50.0
911,Brent Larkham,Hard,2,2,4,12,50.0
912,Brent Pirow,Clay,1,7,8,11,12.5
913,Brent Pirow,Hard,1,2,3,11,33.33
914,Bret Garnett,Carpet,1,1,2,27,50.0
915,Bret Garnett,Grass,1,6,7,27,14.29
916,Bret Garnett,Hard,6,12,18,27,33.33
917,Brett Custer,Hard,1,3,4,4,25.0
918,Brett Dickinson,Hard,3,4,7,7,42.86
919,Brett Steven,Carpet,34,33,67,343,50.75
920,Brett Steven,Clay,15,20,35,343,42.86
921,Brett Steven,Grass,35,24,59,343,59.32
922,Brett Steven,Hard,91,91,182,343,50.0
923,Brian Baker,Clay,5,4,9,60,55.56
924,Brian Baker,Grass,5,5,10,60,50.0
925,Brian Baker,Hard,10,31,41,60,24.39
926,Brian Benson,Grass,1,1,2,2,50.0
927,Brian Bowman,Grass,1,1,2,2,50.0
928,Brian Cheney,Grass,1,2,3,3,33.33
929,Brian Connor,Grass,1,2,3,3,33.33
930,Brian Dabul,Clay,7,13,20,42,35.0
931,Brian Dabul,Grass,3,4,7,42,42.86
932,Brian Dabul,Hard,5,10,15,42,33.33
933,Brian Devening,Clay,2,3,5,5,40.0
934,Brian Dunn,Clay,2,4,6,16,33.33
935,Brian Dunn,Hard,2,8,10,16,20.0
936,Brian Fairlie,Carpet,36,41,77,414,46.75
937,Brian Fairlie,Clay,70,73,143,414,48.95
938,Brian Fairlie,Grass,52,42,94,414,55.32
939,Brian Fairlie,Hard,52,48,100,414,52.0
940,Brian Flood,Clay,1,1,2,2,50.0
941,Brian Ford,Grass,1,1,2,2,50.0
942,Brian Garrow,Carpet,5,6,11,38,45.45
943,Brian Garrow,Grass,1,5,6,38,16.67
944,Brian Garrow,Hard,6,15,21,38,28.57
945,Brian Gottfried,Carpet,193,86,279,1010,69.18
946,Brian Gottfried,Clay,166,97,263,1010,63.12
947,Brian Gottfried,Grass,76,38,114,1010,66.67
948,Brian Gottfried,Hard,253,101,354,1010,71.47
949,Brian Levine,Clay,2,2,4,13,50.0
950,Brian Levine,Hard,3,6,9,13,33.33
951,Brian Macphie,Carpet,1,1,2,64,50.0
952,Brian Macphie,Grass,8,8,16,64,50.0
953,Brian Macphie,Hard,18,28,46,64,39.13
954,Brian Marcus,Hard,1,2,3,3,33.33
955,Brian Page,Hard,2,2,4,4,50.0
956,Brian Teacher,Carpet,84,62,146,571,57.53
957,Brian Teacher,Clay,51,47,98,571,52.04
958,Brian Teacher,Grass,86,47,133,571,64.66
959,Brian Teacher,Hard,115,79,194,571,59.28
960,Brian Vahaly,Clay,1,5,6,64,16.67
961,Brian Vahaly,Grass,3,7,10,64,30.0
962,Brian Vahaly,Hard,17,31,48,64,35.42
963,Brian Wilson,Hard,1,3,4,4,25.0
964,Broderick Dyke,Carpet,19,21,40,199,47.5
965,Broderick Dyke,Clay,5,16,21,199,23.81
966,Broderick Dyke,Grass,19,30,49,199,38.78
967,Broderick Dyke,Hard,35,54,89,199,39.33
968,Bruce Derlin,Clay,10,23,33,99,30.3
969,Bruce Derlin,Grass,8,18,26,99,30.77
970,Bruce Derlin,Hard,18,22,40,99,45.0
971,Bruce Foxworth,Clay,4,7,11,20,36.36
972,Bruce Foxworth,Hard,4,5,9,20,44.44
973,Bruce Kleege,Carpet,2,8,10,45,20.0
974,Bruce Kleege,Clay,3,6,9,45,33.33
975,Bruce Kleege,Grass,2,7,9,45,22.22
976,Bruce Kleege,Hard,3,14,17,45,17.65
977,Bruce Manson,Carpet,35,50,85,299,41.18
978,Bruce Manson,Clay,35,45,80,299,43.75
979,Bruce Manson,Grass,7,14,21,299,33.33
980,Bruce Manson,Hard,52,61,113,299,46.02
981,Bruce Nichols,Clay,2,7,9,17,22.22
982,Bruce Nichols,Hard,1,7,8,17,12.5
983,Bruno Agostinelli,Clay,1,1,2,2,50.0
984,Bruno Dadillon,Clay,2,3,5,5,40.0
985,Bruno Echagaray,Clay,3,6,9,11,33.33
986,Bruno Echagaray,Hard,1,1,2,11,50.0
987,Bruno Fragoso,Clay,1,2,3,3,33.33
988,Bruno Oresar,Carpet,3,7,10,127,30.0
989,Bruno Oresar,Clay,40,44,84,127,47.62
990,Bruno Oresar,Hard,14,19,33,127,42.42
991,Bruno Rodriguez,Carpet,1,1,2,6,50.0
992,Bruno Rodriguez,Clay,3,1,4,6,75.0
993,Bryan Juinio,Hard,6,2,8,8,75.0
994,Bryan Shelton,Carpet,5,11,16,242,31.25
995,Bryan Shelton,Clay,34,36,70,242,48.57
996,Bryan Shelton,Grass,24,21,45,242,53.33
997,Bryan Shelton,Hard,41,70,111,242,36.94
998,Brydan Klein,Grass,1,5,6,14,16.67
999,Brydan Klein,Hard,2,6,8,14,25.0
1000,Bud Schultz,Carpet,7,13,20,101,35.0
1001,Bud Schultz,Clay,1,5,6,101,16.67
1002,Bud Schultz,Grass,13,10,23,101,56.52
1003,Bud Schultz,Hard,26,26,52,101,50.0
1004,Buff Farrow,Hard,2,3,5,5,40.0
1005,Buster C Mottram,Carpet,63,51,114,485,55.26
1006,Buster C Mottram,Clay,166,87,253,485,65.61
1007,Buster C Mottram,Grass,25,19,44,485,56.82
1008,Buster C Mottram,Hard,46,28,74,485,62.16
1009,Butch Seewagen,Carpet,2,4,6,106,33.33
1010,Butch Seewagen,Clay,18,28,46,106,39.13
1011,Butch Seewagen,Grass,16,19,35,106,45.71
1012,Butch Seewagen,Hard,6,13,19,106,31.58
1013,Butch Walts,Carpet,62,54,116,277,53.45
1014,Butch Walts,Clay,14,21,35,277,40.0
1015,Butch Walts,Grass,9,11,20,277,45.0
1016,Butch Walts,Hard,56,50,106,277,52.83
1017,Byron Bertram,Carpet,25,29,54,227,46.3
1018,Byron Bertram,Clay,23,39,62,227,37.1
1019,Byron Bertram,Grass,18,19,37,227,48.65
1020,Byron Bertram,Hard,30,44,74,227,40.54
1021,Byron Black,Carpet,38,37,75,529,50.67
1022,Byron Black,Clay,17,27,44,529,38.64
1023,Byron Black,Grass,55,35,90,529,61.11
1024,Byron Black,Hard,169,151,320,529,52.81
1025,Byron Talbot,Hard,1,4,5,5,20.0
1026,C J Bendall,Grass,1,1,2,2,50.0
1027,C Munoz,Clay,4,3,7,7,57.14
1028,C Wijono,Grass,1,1,2,2,50.0
1029,Caio Zampieri,Clay,1,2,3,3,33.33
1030,Calvin Hemery,Clay,2,5,7,7,28.57
1031,Cameron Norrie,Clay,10,13,23,119,43.48
1032,Cameron Norrie,Grass,5,9,14,119,35.71
1033,Cameron Norrie,Hard,41,41,82,119,50.0
1034,Carl Axel Hageskog,Clay,2,2,4,4,50.0
1035,Carl Edvard Hedelund,Clay,2,10,12,12,16.67
1036,Carl Limberger,Carpet,1,5,6,110,16.67
1037,Carl Limberger,Clay,14,28,42,110,33.33
1038,Carl Limberger,Grass,1,13,14,110,7.14
1039,Carl Limberger,Hard,18,30,48,110,37.5
1040,Carl Soderlund,Clay,1,1,2,2,50.0
1041,Carl Uwe Steeb,Carpet,59,52,111,425,53.15
1042,Carl Uwe Steeb,Clay,86,95,181,425,47.51
1043,Carl Uwe Steeb,Grass,2,7,9,425,22.22
1044,Carl Uwe Steeb,Hard,65,59,124,425,52.42
1045,Carlos Alcaraz Garfia,Clay,1,1,2,7,50.0
1046,Carlos Alcaraz Garfia,Hard,3,2,5,7,60.0
1047,Carlos Alvarado,Clay,1,4,5,5,20.0
1048,Carlos Avellan,Clay,6,5,11,17,54.55
1049,Carlos Avellan,Hard,3,3,6,17,50.0
1050,Carlos Behar,Clay,1,2,3,3,33.33
1051,Carlos Berlocq,Clay,101,117,218,328,46.33
1052,Carlos Berlocq,Grass,6,18,24,328,25.0
1053,Carlos Berlocq,Hard,28,58,86,328,32.56
1054,Carlos Castellan,Clay,26,42,68,70,38.24
1055,Carlos Castellan,Hard,1,1,2,70,50.0
1056,Carlos Chabalgoity,Hard,2,1,3,3,66.67
1057,Carlos Claverie,Clay,2,2,4,22,50.0
1058,Carlos Claverie,Hard,8,10,18,22,44.44
1059,Carlos Costa,Carpet,5,19,24,456,20.83
1060,Carlos Costa,Clay,196,131,327,456,59.94
1061,Carlos Costa,Grass,3,5,8,456,37.5
1062,Carlos Costa,Hard,44,53,97,456,45.36
1063,Carlos Cuadrado,Clay,4,4,8,8,50.0
1064,Carlos Di Laura,Clay,10,26,36,47,27.78
1065,Carlos Di Laura,Hard,3,8,11,47,27.27
1066,Carlos Gattiker,Carpet,1,1,2,25,50.0
1067,Carlos Gattiker,Clay,1,22,23,25,4.35
1068,Carlos Gomez,Clay,1,5,6,6,16.67
1069,Carlos Kirmayr,Carpet,12,20,32,317,37.5
1070,Carlos Kirmayr,Clay,98,106,204,317,48.04
1071,Carlos Kirmayr,Grass,9,12,21,317,42.86
1072,Carlos Kirmayr,Hard,28,32,60,317,46.67
1073,Carlos Lando,Clay,1,7,8,8,12.5
1074,Carlos Moya,Carpet,14,20,34,900,41.18
1075,Carlos Moya,Clay,339,143,482,900,70.33
1076,Carlos Moya,Grass,13,15,28,900,46.43
1077,Carlos Moya,Hard,212,144,356,900,59.55
1078,Carlos Salamanca,Clay,3,1,4,4,75.0
1079,Carlos Taberner,Clay,1,3,4,6,25.0
1080,Carlos Taberner,Hard,1,1,2,6,50.0
1081,Carsten Arriens,Clay,9,14,23,60,39.13
1082,Carsten Arriens,Hard,19,18,37,60,51.35
1083,Carsten Ball,Clay,4,2,6,24,66.67
1084,Carsten Ball,Hard,7,11,18,24,38.89
1085,Cary Leeds,Hard,1,6,7,7,14.29
1086,Cary Stansbury,Carpet,1,3,4,26,25.0
1087,Cary Stansbury,Clay,1,5,6,26,16.67
1088,Cary Stansbury,Hard,5,11,16,26,31.25
1089,Casper Ruud,Clay,46,25,71,111,64.79
1090,Casper Ruud,Hard,14,26,40,111,35.0
1091,Cassio Motta,Carpet,9,16,25,296,36.0
1092,Cassio Motta,Clay,64,102,166,296,38.55
1093,Cassio Motta,Grass,8,12,20,296,40.0
1094,Cassio Motta,Hard,35,50,85,296,41.18
1095,Cecil Mamiit,Carpet,2,3,5,167,40.0
1096,Cecil Mamiit,Clay,7,16,23,167,30.43
1097,Cecil Mamiit,Grass,4,13,17,167,23.53
1098,Cecil Mamiit,Hard,46,76,122,167,37.7
1099,Cecil Pedlow,Grass,1,1,2,2,50.0
1100,Cedric Pioline,Carpet,75,64,139,708,53.96
1101,Cedric Pioline,Clay,118,102,220,708,53.64
1102,Cedric Pioline,Grass,46,31,77,708,59.74
1103,Cedric Pioline,Hard,151,121,272,708,55.51
1104,Cedrik Marcel Stebe,Clay,18,16,34,78,52.94
1105,Cedrik Marcel Stebe,Grass,2,6,8,78,25.0
1106,Cedrik Marcel Stebe,Hard,11,25,36,78,30.56
1107,Cem Ilkel,Hard,4,10,14,14,28.57
1108,Cesar Kist,Clay,4,9,13,21,30.77
1109,Cesar Kist,Hard,2,6,8,21,25.0
1110,Cesar Ramirez,Clay,7,8,15,18,46.67
1111,Cesar Ramirez,Hard,1,2,3,18,33.33
1112,Chaim Arlozorov,Hard,1,3,4,4,25.0
1113,Chang Rung Wu,Hard,13,11,24,24,54.17
1114,Charles Auffray,Clay,1,6,7,7,14.29
1115,Charles Beckman,Hard,1,3,4,4,25.0
1116,Charles Bud Cox,Carpet,2,2,4,23,50.0
1117,Charles Bud Cox,Clay,2,5,7,23,28.57
1118,Charles Bud Cox,Hard,3,9,12,23,25.0
1119,Charles Buzz Strode,Carpet,1,3,4,28,25.0
1120,Charles Buzz Strode,Clay,4,9,13,28,30.77
1121,Charles Buzz Strode,Hard,3,8,11,28,27.27
1122,Charles Mckinley,Grass,2,2,4,4,50.0
1123,Charles Owens,Carpet,15,26,41,120,36.59
1124,Charles Owens,Clay,11,18,29,120,37.93
1125,Charles Owens,Grass,7,9,16,120,43.75
1126,Charles Owens,Hard,16,18,34,120,47.06
1127,Charlie Fancutt,Clay,4,4,8,59,50.0
1128,Charlie Fancutt,Grass,15,26,41,59,36.59
1129,Charlie Fancutt,Hard,3,7,10,59,30.0
1130,Charlie Pasarell,Carpet,71,69,140,474,50.71
1131,Charlie Pasarell,Clay,50,55,105,474,47.62
1132,Charlie Pasarell,Grass,55,34,89,474,61.8
1133,Charlie Pasarell,Hard,64,76,140,474,45.71
1134,Charlton Eagle,Grass,1,3,4,4,25.0
1135,Chauncey Steele Iii,Grass,7,9,16,16,43.75
1136,Chee Yen Chen,Hard,1,3,4,4,25.0
1137,Cheuk Wai Hui,Hard,1,1,2,2,50.0
1138,Chi Wan Kim,Hard,1,2,3,3,33.33
1139,Chia Yen Tsai,Carpet,1,1,2,21,50.0
1140,Chia Yen Tsai,Clay,2,3,5,21,40.0
1141,Chia Yen Tsai,Hard,7,7,14,21,50.0
1142,Chieh Fu Wang,Hard,2,1,3,3,66.67
1143,Chih Jung Chen,Carpet,1,2,3,23,33.33
1144,Chih Jung Chen,Clay,5,6,11,23,45.45
1145,Chih Jung Chen,Hard,5,4,9,23,55.56
1146,Chip Hooper,Carpet,37,35,72,223,51.39
1147,Chip Hooper,Clay,7,9,16,223,43.75
1148,Chip Hooper,Grass,13,19,32,223,40.62
1149,Chip Hooper,Hard,47,56,103,223,45.63
1150,Chiradip Mukerjea,Clay,1,2,3,3,33.33
1151,Chiraid Mukherjea,Clay,1,3,4,11,25.0
1152,Chiraid Mukherjea,Grass,3,4,7,11,42.86
1153,Choon Ho Kim,Clay,4,6,10,10,40.0
1154,Chris Bailey,Grass,9,19,28,47,32.14
1155,Chris Bailey,Hard,7,12,19,47,36.84
1156,Chris Bovett,Grass,1,3,4,4,25.0
1157,Chris Bradnam,Clay,1,1,2,2,50.0
1158,Chris Brandi,Hard,2,1,3,3,66.67
1159,Chris Delaney,Carpet,6,8,14,60,42.86
1160,Chris Delaney,Clay,5,10,15,60,33.33
1161,Chris Delaney,Grass,11,9,20,60,55.0
1162,Chris Delaney,Hard,4,7,11,60,36.36
1163,Chris Dunk,Carpet,7,7,14,50,50.0
1164,Chris Dunk,Clay,1,3,4,50,25.0
1165,Chris Dunk,Grass,2,9,11,50,18.18
1166,Chris Dunk,Hard,8,13,21,50,38.1
1167,Chris Eaton,Grass,1,1,2,4,50.0
1168,Chris Eaton,Hard,1,1,2,4,50.0
1169,Chris Garner,Carpet,4,3,7,60,57.14
1170,Chris Garner,Clay,6,11,17,60,35.29
1171,Chris Garner,Hard,13,23,36,60,36.11
1172,Chris Guccione,Clay,2,12,14,110,14.29
1173,Chris Guccione,Grass,8,12,20,110,40.0
1174,Chris Guccione,Hard,35,41,76,110,46.05
1175,Chris Gunning,Grass,2,2,4,7,50.0
1176,Chris Gunning,Hard,1,2,3,7,33.33
1177,Chris Haggard,Grass,1,2,3,3,33.33
1178,Chris Johnstone,Carpet,6,9,15,99,40.0
1179,Chris Johnstone,Clay,6,17,23,99,26.09
1180,Chris Johnstone,Grass,21,28,49,99,42.86
1181,Chris Johnstone,Hard,3,9,12,99,25.0
1182,Chris Kachel,Carpet,1,8,9,113,11.11
1183,Chris Kachel,Clay,5,22,27,113,18.52
1184,Chris Kachel,Grass,18,35,53,113,33.96
1185,Chris Kachel,Hard,6,18,24,113,25.0
1186,Chris Lewis,Carpet,17,24,41,419,41.46
1187,Chris Lewis,Clay,114,88,202,419,56.44
1188,Chris Lewis,Grass,58,49,107,419,54.21
1189,Chris Lewis,Hard,36,33,69,419,52.17
1190,Chris Mayotte,Carpet,3,8,11,92,27.27
1191,Chris Mayotte,Clay,13,23,36,92,36.11
1192,Chris Mayotte,Grass,1,7,8,92,12.5
1193,Chris Mayotte,Hard,17,20,37,92,45.95
1194,Chris Pridham,Carpet,11,14,25,134,44.0
1195,Chris Pridham,Clay,1,4,5,134,20.0
1196,Chris Pridham,Grass,6,11,17,134,35.29
1197,Chris Pridham,Hard,36,51,87,134,41.38
1198,Chris Walsh,Grass,1,1,2,2,50.0
1199,Chris Wilkinson,Carpet,1,2,3,78,33.33
1200,Chris Wilkinson,Clay,2,3,5,78,40.0
1201,Chris Wilkinson,Grass,20,25,45,78,44.44
1202,Chris Wilkinson,Hard,5,20,25,78,20.0
1203,Chris Woodruff,Carpet,12,9,21,216,57.14
1204,Chris Woodruff,Clay,19,22,41,216,46.34
1205,Chris Woodruff,Grass,10,10,20,216,50.0
1206,Chris Woodruff,Hard,68,66,134,216,50.75
1207,Christer Allgardh,Clay,12,17,29,38,41.38
1208,Christer Allgardh,Hard,2,7,9,38,22.22
1209,Christian Bergstrom,Carpet,34,37,71,326,47.89
1210,Christian Bergstrom,Clay,46,55,101,326,45.54
1211,Christian Bergstrom,Grass,14,13,27,326,51.85
1212,Christian Bergstrom,Hard,68,59,127,326,53.54
1213,Christian Garay,Hard,3,2,5,5,60.0
1214,Christian Garin,Clay,43,21,64,112,67.19
1215,Christian Garin,Grass,2,5,7,112,28.57
1216,Christian Garin,Hard,15,26,41,112,36.59
1217,Christian Geyer,Carpet,1,2,3,6,33.33
1218,Christian Geyer,Clay,1,2,3,6,33.33
1219,Christian Harrison,Grass,1,2,3,12,33.33
1220,Christian Harrison,Hard,4,5,9,12,44.44
1221,Christian Kuhnke,Clay,29,15,44,55,65.91
1222,Christian Kuhnke,Grass,1,1,2,55,50.0
1223,Christian Kuhnke,Hard,3,6,9,55,33.33
1224,Christian Lindell,Clay,5,10,15,15,33.33
1225,Christian Miniussi,Clay,53,66,119,136,44.54
1226,Christian Miniussi,Hard,6,11,17,136,35.29
1227,Christian Ruud,Carpet,3,7,10,264,30.0
1228,Christian Ruud,Clay,92,84,176,264,52.27
1229,Christian Ruud,Hard,29,49,78,264,37.18
1230,Christian Saceanu,Carpet,17,21,38,183,44.74
1231,Christian Saceanu,Clay,10,19,29,183,34.48
1232,Christian Saceanu,Grass,23,19,42,183,54.76
1233,Christian Saceanu,Hard,21,53,74,183,28.38
1234,Christian Vinck,Clay,4,15,19,61,21.05
1235,Christian Vinck,Grass,5,8,13,61,38.46
1236,Christian Vinck,Hard,8,21,29,61,27.59
1237,Christo Steyn,Carpet,3,7,10,96,30.0
1238,Christo Steyn,Clay,4,7,11,96,36.36
1239,Christo Steyn,Grass,16,12,28,96,57.14
1240,Christo Steyn,Hard,20,27,47,96,42.55
1241,Christo Van Rensburg,Carpet,24,28,52,326,46.15
1242,Christo Van Rensburg,Clay,1,10,11,326,9.09
1243,Christo Van Rensburg,Grass,55,35,90,326,61.11
1244,Christo Van Rensburg,Hard,86,87,173,326,49.71
1245,Christoph Meyer,Clay,3,3,6,6,50.0
1246,Christoph Zipf,Carpet,4,5,9,43,44.44
1247,Christoph Zipf,Clay,5,15,20,43,25.0
1248,Christoph Zipf,Hard,6,8,14,43,42.86
1249,Christophe Bernelle,Clay,1,3,4,4,25.0
1250,Christophe Boggetti,Clay,4,6,10,12,40.0
1251,Christophe Boggetti,Hard,1,1,2,12,50.0
1252,Christophe Casa,Carpet,1,3,4,47,25.0
1253,Christophe Casa,Clay,15,28,43,47,34.88
1254,Christophe Freyss,Carpet,1,6,7,129,14.29
1255,Christophe Freyss,Clay,44,59,103,129,42.72
1256,Christophe Freyss,Hard,4,15,19,129,21.05
1257,Christophe Lesage,Clay,1,2,3,3,33.33
1258,Christophe Rochus,Carpet,5,14,19,337,26.32
1259,Christophe Rochus,Clay,69,97,166,337,41.57
1260,Christophe Rochus,Grass,3,22,25,337,12.0
1261,Christophe Rochus,Hard,41,86,127,337,32.28
1262,Christophe Roger Vasselin,Carpet,7,21,28,221,25.0
1263,Christophe Roger Vasselin,Clay,53,66,119,221,44.54
1264,Christophe Roger Vasselin,Grass,2,8,10,221,20.0
1265,Christophe Roger Vasselin,Hard,29,35,64,221,45.31
1266,Christophe Van Garsse,Carpet,1,1,2,37,50.0
1267,Christophe Van Garsse,Clay,12,6,18,37,66.67
1268,Christophe Van Garsse,Grass,2,2,4,37,50.0
1269,Christophe Van Garsse,Hard,6,7,13,37,46.15
1270,Christopher Diaz Figueroa,Clay,1,5,6,19,16.67
1271,Christopher Diaz Figueroa,Hard,7,6,13,19,53.85
1272,Christopher Eubanks,Grass,1,1,2,18,50.0
1273,Christopher Eubanks,Hard,3,13,16,18,18.75
1274,Christopher Gatt,Clay,1,3,4,6,25.0
1275,Christopher Gatt,Hard,1,1,2,6,50.0
1276,Christopher O'Connell,Hard,3,6,9,9,33.33
1277,Christopher Rungkat,Hard,17,12,29,29,58.62
1278,Christopher Sylvan,Clay,1,4,5,8,20.0
1279,Christopher Sylvan,Hard,2,1,3,8,66.67
1280,Chuck Adams,Carpet,11,9,20,176,55.0
1281,Chuck Adams,Clay,1,11,12,176,8.33
1282,Chuck Adams,Grass,3,7,10,176,30.0
1283,Chuck Adams,Hard,68,66,134,176,50.75
1284,Chuhan Wang,Hard,1,2,3,3,33.33
1285,Chun Hsin Tseng,Hard,3,3,6,6,50.0
1286,Chung Hsing Liu,Hard,7,10,17,17,41.18
1287,Clark Graebner,Carpet,29,28,57,350,50.88
1288,Clark Graebner,Clay,51,25,76,350,67.11
1289,Clark Graebner,Grass,63,23,86,350,73.26
1290,Clark Graebner,Hard,89,42,131,350,67.94
1291,Claude De Gronckel,Clay,1,6,7,7,14.29
1292,Claude Ngoran,Carpet,4,4,8,44,50.0
1293,Claude Ngoran,Clay,7,5,12,44,58.33
1294,Claude Ngoran,Hard,15,9,24,44,62.5
1295,Claudio Mezzadri,Carpet,8,15,23,256,34.78
1296,Claudio Mezzadri,Clay,91,95,186,256,48.92
1297,Claudio Mezzadri,Grass,1,3,4,256,25.0
1298,Claudio Mezzadri,Hard,17,26,43,256,39.53
1299,Claudio Panatta,Carpet,3,7,10,247,30.0
1300,Claudio Panatta,Clay,84,105,189,247,44.44
1301,Claudio Panatta,Grass,4,8,12,247,33.33
1302,Claudio Panatta,Hard,14,22,36,247,38.89
1303,Claudio Pistolesi,Clay,74,87,161,185,45.96
1304,Claudio Pistolesi,Grass,1,4,5,185,20.0
1305,Claudio Pistolesi,Hard,2,17,19,185,10.53
1306,Clay Iles,Grass,2,2,4,4,50.0
1307,Clemens Trimmel,Clay,1,6,7,7,14.29
1308,Clement Morel,Clay,1,1,2,2,50.0
1309,Clement Ngoran,Carpet,3,1,4,31,75.0
1310,Clement Ngoran,Clay,4,4,8,31,50.0
1311,Clement Ngoran,Hard,13,6,19,31,68.42
1312,Clement Reix,Hard,1,1,2,2,50.0
1313,Cliff Drysdale,Carpet,97,80,177,555,54.8
1314,Cliff Drysdale,Clay,90,42,132,555,68.18
1315,Cliff Drysdale,Grass,50,27,77,555,64.94
1316,Cliff Drysdale,Hard,109,60,169,555,64.5
1317,Cliff Letcher,Carpet,3,10,13,182,23.08
1318,Cliff Letcher,Clay,15,40,55,182,27.27
1319,Cliff Letcher,Grass,34,45,79,182,43.04
1320,Cliff Letcher,Hard,10,25,35,182,28.57
1321,Cliff Richey,Carpet,86,54,140,587,61.43
1322,Cliff Richey,Clay,129,55,184,587,70.11
1323,Cliff Richey,Grass,40,21,61,587,65.57
1324,Cliff Richey,Hard,142,60,202,587,70.3
1325,Cliff Skakle,Hard,1,2,3,3,33.33
1326,Clinton Marsh,Hard,1,5,6,6,16.67
1327,Clive Brebnor,Hard,3,6,9,9,33.33
1328,Clive Wilderspin,Grass,1,1,2,2,50.0
1329,Cm Robinson,Clay,1,1,2,2,50.0
1330,Colin Beecher,Grass,1,2,3,3,33.33
1331,Colin Dibley,Carpet,51,61,112,605,45.54
1332,Colin Dibley,Clay,73,79,152,605,48.03
1333,Colin Dibley,Grass,94,68,162,605,58.02
1334,Colin Dibley,Hard,86,93,179,605,48.04
1335,Colin Diederichs,Hard,1,2,3,3,33.33
1336,Colin Dowdeswell,Carpet,2,18,20,282,10.0
1337,Colin Dowdeswell,Clay,60,93,153,282,39.22
1338,Colin Dowdeswell,Grass,10,20,30,282,33.33
1339,Colin Dowdeswell,Hard,38,41,79,282,48.1
1340,Colin Grant,Carpet,3,3,6,32,50.0
1341,Colin Grant,Clay,2,2,4,32,50.0
1342,Colin Grant,Hard,12,10,22,32,54.55
1343,Colin Obrien,Grass,1,1,2,5,50.0
1344,Colin Obrien,Hard,2,1,3,5,66.67
1345,Colin Rees,Hard,4,3,7,7,57.14
1346,Colin Stubs,Clay,2,4,6,27,33.33
1347,Colin Stubs,Grass,5,11,16,27,31.25
1348,Colin Stubs,Hard,1,4,5,27,20.0
1349,Conor Niland,Carpet,3,5,8,27,37.5
1350,Conor Niland,Clay,2,4,6,27,33.33
1351,Conor Niland,Grass,1,4,5,27,20.0
1352,Conor Niland,Hard,4,4,8,27,50.0
1353,Constant Lestienne,Hard,1,3,4,4,25.0
1354,Corentin Moutet,Clay,9,17,26,57,34.62
1355,Corentin Moutet,Grass,1,1,2,57,50.0
1356,Corentin Moutet,Hard,13,16,29,57,44.83
1357,Corrado Aprili,Clay,4,15,19,19,21.05
1358,Corrado Barazzutti,Carpet,41,41,82,560,50.0
1359,Corrado Barazzutti,Clay,247,153,400,560,61.75
1360,Corrado Barazzutti,Grass,1,8,9,560,11.11
1361,Corrado Barazzutti,Hard,41,28,69,560,59.42
1362,Corrado Borroni,Clay,2,3,5,5,40.0
1363,Craig A Miller,Carpet,5,8,13,79,38.46
1364,Craig A Miller,Clay,4,9,13,79,30.77
1365,Craig A Miller,Grass,13,25,38,79,34.21
1366,Craig A Miller,Hard,4,11,15,79,26.67
1367,Craig Campbell,Clay,2,5,7,20,28.57
1368,Craig Campbell,Hard,5,8,13,20,38.46
1369,Craig Edwards,Grass,2,4,6,6,33.33
1370,Craig Wittus,Carpet,4,3,7,56,57.14
1371,Craig Wittus,Clay,5,13,18,56,27.78
1372,Craig Wittus,Grass,8,10,18,56,44.44
1373,Craig Wittus,Hard,3,10,13,56,23.08
1374,Cristian Paiz,Hard,3,5,8,8,37.5
1375,Cristiano Caratti,Carpet,14,21,35,189,40.0
1376,Cristiano Caratti,Clay,9,18,27,189,33.33
1377,Cristiano Caratti,Grass,3,11,14,189,21.43
1378,Cristiano Caratti,Hard,46,67,113,189,40.71
1379,Cyril Rudman,Hard,1,2,3,3,33.33
1380,Cyril Saulnier,Carpet,15,12,27,186,55.56
1381,Cyril Saulnier,Clay,2,14,16,186,12.5
1382,Cyril Saulnier,Grass,10,14,24,186,41.67
1383,Cyril Saulnier,Hard,48,71,119,186,40.34
1384,Cyril Suk,Clay,1,10,11,11,9.09
1385,D Beasant,Grass,1,1,2,2,50.0
1386,D Richard Russell,Clay,2,11,13,40,15.38
1387,D Richard Russell,Grass,4,13,17,40,23.53
1388,D Richard Russell,Hard,2,8,10,40,20.0
1389,D Sullivan,Hard,2,1,3,3,66.67
1390,D Turner,Clay,1,1,2,2,50.0
1391,Dacio Campos,Clay,3,9,12,15,25.0
1392,Dacio Campos,Hard,1,2,3,15,33.33
1393,Dale Collings,Clay,2,6,8,62,25.0
1394,Dale Collings,Grass,17,28,45,62,37.78
1395,Dale Collings,Hard,4,5,9,62,44.44
1396,Dale Houston,Grass,2,3,5,5,40.0
1397,Dale Power,Carpet,3,3,6,19,50.0
1398,Dale Power,Clay,1,7,8,19,12.5
1399,Dale Power,Hard,2,3,5,19,40.0
1400,Damar Johnson,Hard,1,1,2,2,50.0
1401,Damir Buljevic,Clay,1,2,3,3,33.33
1402,Damir Dzumhur,Clay,28,33,61,243,45.9
1403,Damir Dzumhur,Grass,10,8,18,243,55.56
1404,Damir Dzumhur,Hard,78,86,164,243,47.56
1405,Damir Keretic,Carpet,5,6,11,219,45.45
1406,Damir Keretic,Clay,73,85,158,219,46.2
1407,Damir Keretic,Grass,7,11,18,219,38.89
1408,Damir Keretic,Hard,10,22,32,219,31.25
1409,Dan Birchmore,Clay,1,2,3,3,33.33
1410,Dan Bleckinger,Clay,2,5,7,15,28.57
1411,Dan Bleckinger,Grass,3,5,8,15,37.5
1412,Dan Cassidy,Carpet,1,11,12,110,8.33
1413,Dan Cassidy,Clay,4,13,17,110,23.53
1414,Dan Cassidy,Grass,7,10,17,110,41.18
1415,Dan Cassidy,Hard,23,41,64,110,35.94
1416,Dan Goldberg,Hard,2,6,8,8,25.0
1417,Dan Goldie,Carpet,20,20,40,239,50.0
1418,Dan Goldie,Clay,4,12,16,239,25.0
1419,Dan Goldie,Grass,19,16,35,239,54.29
1420,Dan Goldie,Hard,79,69,148,239,53.38
1421,Danai Udomchoke,Carpet,5,2,7,131,71.43
1422,Danai Udomchoke,Clay,5,6,11,131,45.45
1423,Danai Udomchoke,Grass,6,13,19,131,31.58
1424,Danai Udomchoke,Hard,44,50,94,131,46.81
1425,Dane Sweeny,Hard,1,1,2,2,50.0
1426,Danie Visser,Carpet,6,11,17,221,35.29
1427,Danie Visser,Clay,4,15,19,221,21.05
1428,Danie Visser,Grass,31,36,67,221,46.27
1429,Danie Visser,Hard,51,67,118,221,43.22
1430,Daniel Alejandro Lopez Cassaccia,Clay,1,6,7,11,14.29
1431,Daniel Alejandro Lopez Cassaccia,Hard,3,1,4,11,75.0
1432,Daniel Altmaier,Clay,3,4,7,10,42.86
1433,Daniel Altmaier,Grass,2,1,3,10,66.67
1434,Daniel Brands,Clay,21,34,55,152,38.18
1435,Daniel Brands,Grass,7,10,17,152,41.18
1436,Daniel Brands,Hard,31,49,80,152,38.75
1437,Daniel Chavez Morales,Hard,4,4,8,8,50.0
1438,Daniel Contet,Clay,12,25,37,49,32.43
1439,Daniel Contet,Grass,3,5,8,49,37.5
1440,Daniel Contet,Hard,2,2,4,49,50.0
1441,Daniel Courcol,Clay,1,2,3,5,33.33
1442,Daniel Courcol,Grass,1,1,2,5,50.0
1443,Daniel Elahi Galan,Clay,8,5,13,25,61.54
1444,Daniel Elahi Galan,Hard,5,7,12,25,41.67
1445,Daniel Elsner,Clay,7,20,27,34,25.93
1446,Daniel Elsner,Hard,1,6,7,34,14.29
1447,Daniel Evans,Clay,4,12,16,161,25.0
1448,Daniel Evans,Grass,11,15,26,161,42.31
1449,Daniel Evans,Hard,63,56,119,161,52.94
1450,Daniel Garza,Carpet,1,1,2,28,50.0
1451,Daniel Garza,Clay,9,9,18,28,50.0
1452,Daniel Garza,Hard,6,2,8,28,75.0
1453,Daniel Gimeno Traver,Clay,78,106,184,270,42.39
1454,Daniel Gimeno Traver,Grass,2,17,19,270,10.53
1455,Daniel Gimeno Traver,Hard,17,50,67,270,25.37
1456,Daniel Glancy,Hard,1,3,4,4,25.0
1457,Daniel Heryanto,Grass,1,1,2,2,50.0
1458,Daniel King Turner,Clay,1,2,3,26,33.33
1459,Daniel King Turner,Hard,12,11,23,26,52.17
1460,Daniel Koellerer,Clay,12,18,30,51,40.0
1461,Daniel Koellerer,Hard,7,14,21,51,33.33
1462,Daniel Kosakowski,Hard,1,2,3,3,33.33
1463,Daniel Marco,Hard,1,1,2,2,50.0
1464,Daniel Masur,Clay,1,3,4,4,25.0
1465,Daniel Munoz de la Nava,Clay,6,21,27,37,22.22
1466,Daniel Munoz de la Nava,Hard,3,7,10,37,30.0
1467,Daniel Nestor,Carpet,11,12,23,205,47.83
1468,Daniel Nestor,Clay,3,12,15,205,20.0
1469,Daniel Nestor,Grass,18,25,43,205,41.86
1470,Daniel Nestor,Hard,54,70,124,205,43.55
1471,Daniel Orsanic,Clay,13,21,34,41,38.24
1472,Daniel Orsanic,Hard,1,6,7,41,14.29
1473,Daniel Vacek,Carpet,48,54,102,403,47.06
1474,Daniel Vacek,Clay,24,44,68,403,35.29
1475,Daniel Vacek,Grass,17,23,40,403,42.5
1476,Daniel Vacek,Hard,88,105,193,403,45.6
1477,Daniel Vallverdu,Hard,3,3,6,6,50.0
1478,Daniele Balducci,Clay,1,3,4,4,25.0
1479,Daniele Bracciali,Carpet,5,8,13,90,38.46
1480,Daniele Bracciali,Clay,10,16,26,90,38.46
1481,Daniele Bracciali,Grass,9,8,17,90,52.94
1482,Daniele Bracciali,Hard,11,23,34,90,32.35
1483,Daniele Musa,Clay,2,6,8,12,25.0
1484,Daniele Musa,Hard,1,3,4,12,25.0
1485,Daniil Medvedev,Clay,10,18,28,251,35.71
1486,Daniil Medvedev,Grass,18,12,30,251,60.0
1487,Daniil Medvedev,Hard,139,54,193,251,72.02
1488,Danilo Marcelino,Carpet,6,10,16,78,37.5
1489,Danilo Marcelino,Hard,23,39,62,78,37.1
1490,Danilo Petrovic,Clay,2,1,3,3,66.67
1491,Danny Obryant,Grass,1,4,5,5,20.0
1492,Danny Saltz,Carpet,1,4,5,37,20.0
1493,Danny Saltz,Clay,2,1,3,37,66.67
1494,Danny Saltz,Grass,4,6,10,37,40.0
1495,Danny Saltz,Hard,10,9,19,37,52.63
1496,Danny Sapsford,Carpet,1,8,9,50,11.11
1497,Danny Sapsford,Clay,5,3,8,50,62.5
1498,Danny Sapsford,Grass,8,14,22,50,36.36
1499,Danny Sapsford,Hard,4,7,11,50,36.36
1500,Danny Sullivan,Hard,1,2,3,3,33.33
1501,Darek Nowicki,Carpet,2,1,3,3,66.67
1502,Darian King,Clay,2,4,6,37,33.33
1503,Darian King,Hard,19,12,31,37,61.29
1504,Darren Cahill,Carpet,17,19,36,257,47.22
1505,Darren Cahill,Clay,32,27,59,257,54.24
1506,Darren Cahill,Grass,21,24,45,257,46.67
1507,Darren Cahill,Hard,65,52,117,257,55.56
1508,Dave Harmon,Clay,1,2,3,3,33.33
1509,Dave Phillips,Hard,1,3,4,4,25.0
1510,Dave Randall,Carpet,2,1,3,22,66.67
1511,Dave Randall,Grass,1,2,3,22,33.33
1512,Dave Randall,Hard,7,9,16,22,43.75
1513,Dave Siegler,Clay,1,5,6,40,16.67
1514,Dave Siegler,Grass,2,6,8,40,25.0
1515,Dave Siegler,Hard,12,14,26,40,46.15
1516,Dave Simmonds,Grass,2,3,5,5,40.0
1517,David Adams,Carpet,3,3,6,27,50.0
1518,David Adams,Grass,4,3,7,27,57.14
1519,David Adams,Hard,2,12,14,27,14.29
1520,David Agung Susanto,Hard,4,10,14,14,28.57
1521,David Brown,Clay,1,4,5,7,20.0
1522,David Brown,Grass,1,1,2,7,50.0
1523,David Caballero,Clay,1,1,2,2,50.0
1524,David Caldwell,Hard,2,9,11,11,18.18
1525,David Carter,Carpet,4,8,12,195,33.33
1526,David Carter,Clay,39,53,92,195,42.39
1527,David Carter,Grass,17,26,43,195,39.53
1528,David Carter,Hard,17,31,48,195,35.42
1529,David De Miguel,Clay,17,29,46,46,36.96
1530,David Dilucia,Carpet,1,4,5,24,20.0
1531,David Dilucia,Grass,2,4,6,24,33.33
1532,David Dilucia,Hard,3,10,13,24,23.08
1533,David Dowlen,Clay,1,4,5,31,20.0
1534,David Dowlen,Grass,1,6,7,31,14.29
1535,David Dowlen,Hard,8,11,19,31,42.11
1536,David Egdes,Hard,1,1,2,2,50.0
1537,David Engel,Carpet,3,7,10,72,30.0
1538,David Engel,Clay,8,18,26,72,30.77
1539,David Engel,Grass,4,3,7,72,57.14
1540,David Engel,Hard,9,20,29,72,31.03
1541,David Felgate,Grass,1,3,4,4,25.0
1542,David Ferrer,Carpet,9,11,20,1119,45.0
1543,David Ferrer,Clay,337,141,478,1119,70.5
1544,David Ferrer,Grass,44,26,70,1119,62.86
1545,David Ferrer,Hard,350,201,551,1119,63.52
1546,David Goffin,Clay,72,46,118,470,61.02
1547,David Goffin,Grass,24,19,43,470,55.81
1548,David Goffin,Hard,190,119,309,470,61.49
1549,David Graham,Hard,1,1,2,2,50.0
1550,David Guez,Hard,2,12,14,14,14.29
1551,David Imonitie,Hard,2,2,4,4,50.0
1552,David Lewis,Clay,1,2,3,27,33.33
1553,David Lewis,Hard,8,16,24,27,33.33
1554,David Livingston,Hard,1,1,2,2,50.0
1555,David Lloyd,Carpet,2,7,9,87,22.22
1556,David Lloyd,Clay,7,25,32,87,21.88
1557,David Lloyd,Grass,16,25,41,87,39.02
1558,David Lloyd,Hard,1,4,5,87,20.0
1559,David Marrero,Clay,3,6,9,9,33.33
1560,David Mitchell,Carpet,1,1,2,2,50.0
1561,David Mustard,Clay,3,6,9,45,33.33
1562,David Mustard,Grass,7,14,21,45,33.33
1563,David Mustard,Hard,4,11,15,45,26.67
1564,David Nainkin,Carpet,3,3,6,72,50.0
1565,David Nainkin,Clay,1,4,5,72,20.0
1566,David Nainkin,Grass,6,8,14,72,42.86
1567,David Nainkin,Hard,17,30,47,72,36.17
1568,David Nalbandian,Carpet,27,12,39,579,69.23
1569,David Nalbandian,Clay,138,71,209,579,66.03
1570,David Nalbandian,Grass,31,14,45,579,68.89
1571,David Nalbandian,Hard,187,99,286,579,65.38
1572,David Pate,Carpet,32,31,63,349,50.79
1573,David Pate,Clay,5,13,18,349,27.78
1574,David Pate,Grass,31,26,57,349,54.39
1575,David Pate,Hard,113,98,211,349,53.55
1576,David Prinosil,Carpet,56,52,108,390,51.85
1577,David Prinosil,Clay,15,48,63,390,23.81
1578,David Prinosil,Grass,35,27,62,390,56.45
1579,David Prinosil,Hard,63,94,157,390,40.13
1580,David Rikl,Carpet,6,8,14,148,42.86
1581,David Rikl,Clay,32,46,78,148,41.03
1582,David Rikl,Grass,2,8,10,148,20.0
1583,David Rikl,Hard,14,32,46,148,30.43
1584,David Sanchez,Clay,78,77,155,199,50.32
1585,David Sanchez,Hard,9,35,44,199,20.45
1586,David Schneider,Carpet,1,11,12,120,8.33
1587,David Schneider,Clay,6,27,33,120,18.18
1588,David Schneider,Grass,5,12,17,120,29.41
1589,David Schneider,Hard,19,39,58,120,32.76
1590,David Segal,Grass,2,2,4,4,50.0
1591,David Sherwood,Grass,1,1,2,2,50.0
1592,David Skoch,Clay,5,8,13,13,38.46
1593,David Smith,Grass,1,1,2,2,50.0
1594,David Souto,Clay,2,2,4,14,50.0
1595,David Souto,Hard,7,3,10,14,70.0
1596,David Wheaton,Carpet,28,35,63,423,44.44
1597,David Wheaton,Clay,30,27,57,423,52.63
1598,David Wheaton,Grass,49,28,77,423,63.64
1599,David Wheaton,Hard,125,101,226,423,55.31
1600,David Witt,Clay,5,5,10,37,50.0
1601,David Witt,Grass,7,6,13,37,53.85
1602,David Witt,Hard,3,11,14,37,21.43
1603,Davide Sanguinetti,Carpet,17,24,41,414,41.46
1604,Davide Sanguinetti,Clay,53,91,144,414,36.81
1605,Davide Sanguinetti,Grass,20,27,47,414,42.55
1606,Davide Sanguinetti,Hard,80,102,182,414,43.96
1607,Davide Scala,Carpet,1,1,2,21,50.0
1608,Davide Scala,Clay,6,10,16,21,37.5
1609,Davide Scala,Hard,1,2,3,21,33.33
1610,Dawid Olejniczak,Hard,3,1,4,4,75.0
1611,Dawood Dawoodian,Hard,3,5,8,8,37.5
1612,Dean Botha,Hard,2,1,3,3,66.67
1613,Dejan Petrovic,Grass,1,3,4,8,25.0
1614,Dejan Petrovic,Hard,1,3,4,8,25.0
1615,Denes Lukacs,Clay,1,3,4,4,25.0
1616,Denis Gremelmayr,Clay,14,16,30,90,46.67
1617,Denis Gremelmayr,Grass,2,8,10,90,20.0
1618,Denis Gremelmayr,Hard,16,34,50,90,32.0
1619,Denis Istomin,Clay,59,71,130,488,45.38
1620,Denis Istomin,Grass,41,35,76,488,53.95
1621,Denis Istomin,Hard,128,154,282,488,45.39
1622,Denis Kudla,Clay,5,14,19,149,26.32
1623,Denis Kudla,Grass,22,21,43,149,51.16
1624,Denis Kudla,Hard,25,62,87,149,28.74
1625,Denis Langaskens,Clay,4,2,6,6,66.67
1626,Denis Matsukevitch,Carpet,1,1,2,2,50.0
1627,Denis Naegelen,Clay,15,20,35,41,42.86
1628,Denis Naegelen,Grass,1,1,2,41,50.0
1629,Denis Naegelen,Hard,1,3,4,41,25.0
1630,Denis Shapovalov,Clay,17,14,31,192,54.84
1631,Denis Shapovalov,Grass,3,9,12,192,25.0
1632,Denis Shapovalov,Hard,86,63,149,192,57.72
1633,Deniss Pavlovs,Carpet,3,3,6,13,50.0
1634,Deniss Pavlovs,Clay,4,3,7,13,57.14
1635,Dennis Foley,Grass,2,3,5,5,40.0
1636,Dennis Matthews,Grass,2,2,4,14,50.0
1637,Dennis Matthews,Hard,4,6,10,14,40.0
1638,Dennis Novak,Clay,7,10,17,56,41.18
1639,Dennis Novak,Grass,2,2,4,56,50.0
1640,Dennis Novak,Hard,13,22,35,56,37.14
1641,Dennis Novikov,Grass,3,5,8,16,37.5
1642,Dennis Novikov,Hard,2,6,8,16,25.0
1643,Dennis Ralston,Carpet,18,23,41,186,43.9
1644,Dennis Ralston,Clay,16,10,26,186,61.54
1645,Dennis Ralston,Grass,39,18,57,186,68.42
1646,Dennis Ralston,Hard,29,33,62,186,46.77
1647,Dennis Van Scheppingen,Carpet,2,9,11,116,18.18
1648,Dennis Van Scheppingen,Clay,19,25,44,116,43.18
1649,Dennis Van Scheppingen,Grass,7,15,22,116,31.82
1650,Dennis Van Scheppingen,Hard,15,24,39,116,38.46
1651,Denys Maasdorp,Clay,1,1,2,2,50.0
1652,Denys Molchanov,Hard,2,1,3,3,66.67
1653,Deon Joubert,Carpet,4,13,17,115,23.53
1654,Deon Joubert,Clay,16,42,58,115,27.59
1655,Deon Joubert,Grass,3,5,8,115,37.5
1656,Deon Joubert,Hard,16,16,32,115,50.0
1657,Derek Schroder,Clay,2,5,7,34,28.57
1658,Derek Schroder,Grass,2,8,10,34,20.0
1659,Derek Schroder,Hard,5,12,17,34,29.41
1660,Derek Tarr,Clay,11,22,33,58,33.33
1661,Derek Tarr,Grass,1,5,6,58,16.67
1662,Derek Tarr,Hard,6,13,19,58,31.58
1663,Dermot Sweeney,Clay,2,3,5,5,40.0
1664,Derrick Rostagno,Carpet,29,31,60,376,48.33
1665,Derrick Rostagno,Clay,11,26,37,376,29.73
1666,Derrick Rostagno,Grass,42,29,71,376,59.15
1667,Derrick Rostagno,Hard,110,98,208,376,52.88
1668,Desmond Early,Grass,2,3,5,5,40.0
1669,Desmond Tyson,Clay,1,1,2,2,50.0
1670,Detler Herdy,Clay,3,5,8,8,37.5
1671,Devin Mullings,Clay,1,3,4,14,25.0
1672,Devin Mullings,Hard,5,5,10,14,50.0
1673,Di Wu,Clay,3,5,8,49,37.5
1674,Di Wu,Hard,16,25,41,49,39.02
1675,Dias Doskarayev,Hard,2,3,5,5,40.0
1676,Dick Crealy,Carpet,30,46,76,595,39.47
1677,Dick Crealy,Clay,139,123,262,595,53.05
1678,Dick Crealy,Grass,77,67,144,595,53.47
1679,Dick Crealy,Hard,55,58,113,595,48.67
1680,Dick Dell,Carpet,8,18,26,130,30.77
1681,Dick Dell,Clay,15,35,50,130,30.0
1682,Dick Dell,Grass,6,14,20,130,30.0
1683,Dick Dell,Hard,5,29,34,130,14.71
1684,Dick Knight,Grass,2,5,7,7,28.57
1685,Dick Norman,Carpet,4,9,13,99,30.77
1686,Dick Norman,Clay,6,15,21,99,28.57
1687,Dick Norman,Grass,12,17,29,99,41.38
1688,Dick Norman,Hard,8,28,36,99,22.22
1689,Dick R Bohrnstedt,Carpet,9,15,24,87,37.5
1690,Dick R Bohrnstedt,Clay,1,13,14,87,7.14
1691,Dick R Bohrnstedt,Grass,10,13,23,87,43.48
1692,Dick R Bohrnstedt,Hard,8,18,26,87,30.77
1693,Dick Stockton,Carpet,124,76,200,629,62.0
1694,Dick Stockton,Clay,107,58,165,629,64.85
1695,Dick Stockton,Grass,60,39,99,629,60.61
1696,Dick Stockton,Hard,87,78,165,629,52.73
1697,Didac Perez,Clay,1,6,7,7,14.29
1698,Diego Cubas,Hard,1,1,2,2,50.0
1699,Diego Galeano,Clay,6,2,8,12,75.0
1700,Diego Galeano,Hard,2,2,4,12,50.0
1701,Diego Hartfield,Carpet,2,1,3,45,66.67
1702,Diego Hartfield,Clay,15,19,34,45,44.12
1703,Diego Hartfield,Hard,1,7,8,45,12.5
1704,Diego Junqueira,Clay,9,26,35,43,25.71
1705,Diego Junqueira,Hard,2,6,8,43,25.0
1706,Diego Nargiso,Carpet,24,27,51,255,47.06
1707,Diego Nargiso,Clay,32,66,98,255,32.65
1708,Diego Nargiso,Grass,11,15,26,255,42.31
1709,Diego Nargiso,Hard,33,47,80,255,41.25
1710,Diego Perez,Carpet,3,9,12,458,25.0
1711,Diego Perez,Clay,187,170,357,458,52.38
1712,Diego Perez,Hard,36,53,89,458,40.45
1713,Diego Schwartzman,Clay,84,64,148,318,56.76
1714,Diego Schwartzman,Grass,5,10,15,318,33.33
1715,Diego Schwartzman,Hard,83,72,155,318,53.55
1716,Diego Veronelli,Clay,2,2,4,4,50.0
1717,Dieter Kindlmann,Clay,1,6,7,7,14.29
1718,Dieter Schultheiss,Clay,1,3,4,4,25.0
1719,Dimitar Grabuloski,Clay,1,4,5,9,20.0
1720,Dimitar Grabuloski,Hard,1,3,4,9,25.0
1721,Dimitar Kutrovsky,Carpet,1,1,2,11,50.0
1722,Dimitar Kutrovsky,Clay,3,1,4,11,75.0
1723,Dimitar Kutrovsky,Hard,3,2,5,11,60.0
1724,Dimitar Kuzmanov,Clay,3,1,4,23,75.0
1725,Dimitar Kuzmanov,Hard,8,11,19,23,42.11
1726,Dimitri Mazur,Hard,2,1,3,3,66.67
1727,Dimitri Muzyka,Clay,1,1,2,2,50.0
1728,Dimitri Poliakov,Carpet,12,13,25,79,48.0
1729,Dimitri Poliakov,Clay,16,15,31,79,51.61
1730,Dimitri Poliakov,Hard,7,16,23,79,30.43
1731,Dimitri Sturdza,Clay,5,21,26,26,19.23
1732,Dimitru Haradau,Clay,7,10,17,17,41.18
1733,Dineshkanthan Thangarajah,Clay,3,6,9,9,33.33
1734,Dinu Pescariu,Carpet,1,5,6,96,16.67
1735,Dinu Pescariu,Clay,25,41,66,96,37.88
1736,Dinu Pescariu,Grass,1,3,4,96,25.0
1737,Dinu Pescariu,Hard,5,15,20,96,25.0
1738,Diogo Rocha,Clay,1,2,3,3,33.33
1739,Dirk Dier,Clay,5,9,14,19,35.71
1740,Dirk Dier,Hard,1,4,5,19,20.0
1741,Dishan Herath,Clay,1,3,4,4,25.0
1742,Djamel Boudjemline,Clay,6,8,14,18,42.86
1743,Djamel Boudjemline,Hard,1,3,4,18,25.0
1744,Dmitri Tomashevich,Clay,4,3,7,21,57.14
1745,Dmitri Tomashevich,Hard,6,8,14,21,42.86
1746,Dmitriy Makeyev,Hard,2,6,8,8,25.0
1747,Dmitry Popko,Clay,2,1,3,8,66.67
1748,Dmitry Popko,Hard,2,3,5,8,40.0
1749,Dmitry Tursunov,Carpet,13,8,21,455,61.9
1750,Dmitry Tursunov,Clay,29,45,74,455,39.19
1751,Dmitry Tursunov,Grass,37,30,67,455,55.22
1752,Dmitry Tursunov,Hard,154,139,293,455,52.56
1753,Dominic Durand,Hard,1,1,2,2,50.0
1754,Dominic Thiem,Clay,140,48,188,463,74.47
1755,Dominic Thiem,Grass,15,14,29,463,51.72
1756,Dominic Thiem,Hard,148,98,246,463,60.16
1757,Dominik Hrbaty,Carpet,38,29,67,679,56.72
1758,Dominik Hrbaty,Clay,133,115,248,679,53.63
1759,Dominik Hrbaty,Grass,6,19,25,679,24.0
1760,Dominik Hrbaty,Hard,184,155,339,679,54.28
1761,Dominik Koepfer,Clay,5,5,10,29,50.0
1762,Dominik Koepfer,Grass,1,1,2,29,50.0
1763,Dominik Koepfer,Hard,7,10,17,29,41.18
1764,Dominik Meffert,Clay,1,2,3,13,33.33
1765,Dominik Meffert,Grass,1,2,3,13,33.33
1766,Dominik Meffert,Hard,3,4,7,13,42.86
1767,Dominique Bedel,Carpet,5,10,15,146,33.33
1768,Dominique Bedel,Clay,52,58,110,146,47.27
1769,Dominique Bedel,Hard,3,18,21,146,14.29
1770,Don Mccormick,Carpet,1,2,3,18,33.33
1771,Don Mccormick,Clay,1,7,8,18,12.5
1772,Don Mccormick,Grass,1,4,5,18,20.0
1773,Don Mccormick,Hard,1,1,2,18,50.0
1774,Don O'Connell,Grass,1,1,2,2,50.0
1775,Donald Dell,Clay,1,7,8,10,12.5
1776,Donald Dell,Hard,1,1,2,10,50.0
1777,Donald Johnson,Clay,5,9,14,21,35.71
1778,Donald Johnson,Hard,2,5,7,21,28.57
1779,Donald Watt,Grass,2,1,3,3,66.67
1780,Donald Young,Clay,7,25,32,315,21.88
1781,Donald Young,Grass,15,24,39,315,38.46
1782,Donald Young,Hard,104,140,244,315,42.62
1783,Dong Hyun Kim,Hard,1,1,2,2,50.0
1784,Dong Wook Song,Clay,2,2,4,19,50.0
1785,Dong Wook Song,Hard,7,8,15,19,46.67
1786,Doug Burke,Clay,2,4,6,26,33.33
1787,Doug Burke,Hard,12,8,20,26,60.0
1788,Doug Crawford,Carpet,1,5,6,50,16.67
1789,Doug Crawford,Clay,15,29,44,50,34.09
1790,Doug Flach,Carpet,3,4,7,74,42.86
1791,Doug Flach,Clay,1,8,9,74,11.11
1792,Doug Flach,Grass,8,9,17,74,47.06
1793,Doug Flach,Hard,16,25,41,74,39.02
1794,Doug Smith,Grass,1,1,2,2,50.0
1795,Doug Verdieck,Hard,1,2,3,3,33.33
1796,Douglas Palm,Carpet,3,7,10,61,30.0
1797,Douglas Palm,Clay,5,17,22,61,22.73
1798,Douglas Palm,Grass,1,6,7,61,14.29
1799,Douglas Palm,Hard,7,15,22,61,31.82
1800,Dovydas Sakinis,Hard,2,1,3,3,66.67
1801,Drew Gitlin,Carpet,3,10,13,82,23.08
1802,Drew Gitlin,Clay,14,12,26,82,53.85
1803,Drew Gitlin,Grass,10,13,23,82,43.48
1804,Drew Gitlin,Hard,7,13,20,82,35.0
1805,Duck Hee Lee,Hard,1,1,2,2,50.0
1806,Dudi Sela,Clay,8,35,43,333,18.6
1807,Dudi Sela,Grass,26,28,54,333,48.15
1808,Dudi Sela,Hard,106,130,236,333,44.92
1809,Duilio Beretta,Clay,7,8,15,17,46.67
1810,Duilio Beretta,Hard,1,1,2,17,50.0
1811,Dusan Lajovic,Clay,76,74,150,305,50.67
1812,Dusan Lajovic,Grass,4,12,16,305,25.0
1813,Dusan Lajovic,Hard,56,83,139,305,40.29
1814,Dusan Vemic,Carpet,2,2,4,37,50.0
1815,Dusan Vemic,Clay,10,8,18,37,55.56
1816,Dusan Vemic,Grass,3,3,6,37,50.0
1817,Dusan Vemic,Hard,3,6,9,37,33.33
1818,Dustin Brown,Clay,21,31,52,160,40.38
1819,Dustin Brown,Grass,18,22,40,160,45.0
1820,Dustin Brown,Hard,23,45,68,160,33.82
1821,Dzmitry Zhyrmont,Hard,6,6,12,12,50.0
1822,E Davies,Grass,1,1,2,2,50.0
1823,E Victor Seixas,Grass,2,7,9,16,22.22
1824,E Victor Seixas,Hard,3,4,7,16,42.86
1825,Earl Butch Buchholz,Carpet,19,14,33,84,57.58
1826,Earl Butch Buchholz,Clay,6,4,10,84,60.0
1827,Earl Butch Buchholz,Grass,16,8,24,84,66.67
1828,Earl Butch Buchholz,Hard,10,7,17,84,58.82
1829,Edan Leshem,Clay,2,1,3,8,66.67
1830,Edan Leshem,Hard,1,4,5,8,20.0
1831,Eddie Cruz,Clay,1,3,4,13,25.0
1832,Eddie Cruz,Hard,1,8,9,13,11.11
1833,Eddie Dibbs,Carpet,113,70,183,845,61.75
1834,Eddie Dibbs,Clay,372,132,504,845,73.81
1835,Eddie Dibbs,Grass,6,6,12,845,50.0
1836,Eddie Dibbs,Hard,100,46,146,845,68.49
1837,Eddie Edwards,Carpet,5,11,16,221,31.25
1838,Eddie Edwards,Clay,16,26,42,221,38.1
1839,Eddie Edwards,Grass,40,41,81,221,49.38
1840,Eddie Edwards,Hard,26,56,82,221,31.71
1841,Eddie Myers,Grass,1,1,2,2,50.0
1842,Eddy Chala,Clay,1,1,2,2,50.0
1843,Eddy Gonzalez Gonzalez,Hard,1,2,3,3,33.33
1844,Edgar Hernandez Perez,Clay,1,3,4,4,25.0
1845,Edgar Schurmann,Clay,1,1,2,2,50.0
1846,Edgardo Massa,Clay,6,12,18,23,33.33
1847,Edgardo Massa,Hard,2,3,5,23,40.0
1848,Edison Mandarino,Clay,39,26,65,81,60.0
1849,Edison Mandarino,Grass,1,4,5,81,20.0
1850,Edison Mandarino,Hard,6,5,11,81,54.55
1851,Edoardo Mazza,Clay,2,8,10,10,20.0
1852,Edouard Roger Vasselin,Clay,20,33,53,208,37.74
1853,Edouard Roger Vasselin,Grass,16,19,35,208,45.71
1854,Edouard Roger Vasselin,Hard,48,72,120,208,40.0
1855,Edson Krause,Hard,1,1,2,2,50.0
1856,Eduardo Bengoechea,Carpet,4,6,10,219,40.0
1857,Eduardo Bengoechea,Clay,86,98,184,219,46.74
1858,Eduardo Bengoechea,Hard,13,12,25,219,52.0
1859,Eduardo Furusho,Clay,1,1,2,2,50.0
1860,Eduardo Mandarino,Carpet,1,2,3,17,33.33
1861,Eduardo Mandarino,Clay,4,10,14,17,28.57
1862,Eduardo Masso,Carpet,9,18,27,120,33.33
1863,Eduardo Masso,Clay,24,32,56,120,42.86
1864,Eduardo Masso,Grass,3,6,9,120,33.33
1865,Eduardo Masso,Hard,11,17,28,120,39.29
1866,Eduardo Medica,Clay,2,4,6,6,33.33
1867,Eduardo Nicolas,Clay,3,4,7,7,42.86
1868,Eduardo Osta,Clay,5,18,23,23,21.74
1869,Eduardo Rincon,Clay,2,6,8,10,25.0
1870,Eduardo Rincon,Hard,1,1,2,10,50.0
1871,Eduardo Schwank,Clay,31,35,66,105,46.97
1872,Eduardo Schwank,Grass,1,7,8,105,12.5
1873,Eduardo Schwank,Hard,8,23,31,105,25.81
1874,Eduardo Soriano,Clay,1,2,3,3,33.33
1875,Eduardo Velez,Clay,1,2,3,8,33.33
1876,Eduardo Velez,Grass,1,1,2,8,50.0
1877,Eduardo Velez,Hard,1,2,3,8,33.33
1878,Eduardo Zuleta,Clay,4,11,15,15,26.67
1879,Edwin Kempes,Carpet,1,1,2,26,50.0
1880,Edwin Kempes,Clay,5,5,10,26,50.0
1881,Edwin Kempes,Hard,5,9,14,26,35.71
1882,Efe Ustundag,Hard,2,4,6,6,33.33
1883,Egan Adams,Carpet,2,2,4,24,50.0
1884,Egan Adams,Clay,5,15,20,24,25.0
1885,Egor Gerasimov,Clay,5,4,9,70,55.56
1886,Egor Gerasimov,Hard,38,23,61,70,62.3
1887,Eiji Takeuchi,Carpet,1,2,3,7,33.33
1888,Eiji Takeuchi,Clay,1,3,4,7,25.0
1889,Elbert Sie,Hard,4,7,11,11,36.36
1890,Eleazar Davidman,Clay,2,2,4,4,50.0
1891,Elias Ymer,Clay,10,23,33,61,30.3
1892,Elias Ymer,Hard,7,21,28,61,25.0
1893,Eliot Teltscher,Carpet,110,67,177,620,62.15
1894,Eliot Teltscher,Clay,124,74,198,620,62.63
1895,Eliot Teltscher,Grass,6,6,12,620,50.0
1896,Eliot Teltscher,Hard,163,70,233,620,69.96
1897,Elliot Benchetrit,Clay,1,3,4,4,25.0
1898,Ellis Ferreira,Hard,4,5,9,9,44.44
1899,Emad Abou Hamdeh,Hard,1,9,10,10,10.0
1900,Emanuel Couto,Carpet,1,3,4,36,25.0
1901,Emanuel Couto,Clay,13,16,29,36,44.83
1902,Emanuel Couto,Hard,1,2,3,36,33.33
1903,Emil Ruusuvuori,Clay,1,3,4,29,25.0
1904,Emil Ruusuvuori,Hard,13,12,25,29,52.0
1905,Emile Ngoran,Hard,2,4,6,6,33.33
1906,Emilio Benfele Alvarez,Carpet,1,4,5,101,20.0
1907,Emilio Benfele Alvarez,Clay,43,49,92,101,46.74
1908,Emilio Benfele Alvarez,Grass,1,3,4,101,25.0
1909,Emilio Daniel Baez Britez,Clay,4,3,7,7,57.14
1910,Emilio Gomez,Clay,5,5,10,24,50.0
1911,Emilio Gomez,Hard,6,8,14,24,42.86
1912,Emilio Montano,Carpet,1,3,4,70,25.0
1913,Emilio Montano,Clay,12,32,44,70,27.27
1914,Emilio Montano,Grass,1,4,5,70,20.0
1915,Emilio Montano,Hard,6,11,17,70,35.29
1916,Emilio Sanchez,Carpet,21,39,60,725,35.0
1917,Emilio Sanchez,Clay,303,168,471,725,64.33
1918,Emilio Sanchez,Grass,4,10,14,725,28.57
1919,Emilio Sanchez,Hard,105,75,180,725,58.33
1920,Emmanuel Heussner,Clay,2,6,8,8,25.0
1921,Emmanuel Udozorh,Hard,4,3,7,7,57.14
1922,Eno Polo,Carpet,2,2,4,26,50.0
1923,Eno Polo,Clay,5,11,16,26,31.25
1924,Eno Polo,Hard,2,4,6,26,33.33
1925,Enrico Cocchi,Clay,1,2,3,3,33.33
1926,Enrique Caviglia,Clay,2,8,10,10,20.0
1927,Enrique Guerrero,Clay,1,1,2,2,50.0
1928,Eoin Collins,Carpet,6,2,8,17,75.0
1929,Eoin Collins,Hard,1,8,9,17,11.11
1930,Erhan Oral,Hard,1,3,4,4,25.0
1931,Eric Amend,Hard,3,2,5,5,60.0
1932,Eric Deblicker,Carpet,3,4,7,155,42.86
1933,Eric Deblicker,Clay,50,68,118,155,42.37
1934,Eric Deblicker,Grass,2,4,6,155,33.33
1935,Eric Deblicker,Hard,10,14,24,155,41.67
1936,Eric Drossart,Clay,6,20,26,28,23.08
1937,Eric Drossart,Hard,1,1,2,28,50.0
1938,Eric Friedler,Carpet,1,4,5,53,20.0
1939,Eric Friedler,Clay,7,14,21,53,33.33
1940,Eric Friedler,Grass,1,4,5,53,20.0
1941,Eric Friedler,Hard,7,15,22,53,31.82
1942,Eric Fromm,Carpet,5,13,18,134,27.78
1943,Eric Fromm,Clay,27,33,60,134,45.0
1944,Eric Fromm,Grass,2,3,5,134,40.0
1945,Eric Fromm,Hard,17,34,51,134,33.33
1946,Eric Jelen,Carpet,48,38,86,272,55.81
1947,Eric Jelen,Clay,27,46,73,272,36.99
1948,Eric Jelen,Grass,33,19,52,272,63.46
1949,Eric Jelen,Hard,27,34,61,272,44.26
1950,Eric Korita,Carpet,6,8,14,61,42.86
1951,Eric Korita,Clay,8,5,13,61,61.54
1952,Eric Korita,Grass,1,6,7,61,14.29
1953,Eric Korita,Hard,14,13,27,61,51.85
1954,Eric Prodon,Clay,1,16,17,17,5.88
1955,Eric Riley,Grass,1,1,2,2,50.0
1956,Eric Sherbeck,Clay,1,1,2,7,50.0
1957,Eric Sherbeck,Grass,2,3,5,7,40.0
1958,Eric Taino,Clay,1,2,3,33,33.33
1959,Eric Taino,Hard,12,18,30,33,40.0
1960,Eric Wilborts,Clay,5,7,12,17,41.67
1961,Eric Wilborts,Hard,3,2,5,17,60.0
1962,Eric Winogradsky,Carpet,8,9,17,63,47.06
1963,Eric Winogradsky,Clay,7,11,18,63,38.89
1964,Eric Winogradsky,Grass,2,3,5,63,40.0
1965,Eric Winogradsky,Hard,5,18,23,63,21.74
1966,Erick Iskersky,Carpet,4,8,12,92,33.33
1967,Erick Iskersky,Clay,16,24,40,92,40.0
1968,Erick Iskersky,Hard,13,27,40,92,32.5
1969,Erik Melander,Clay,1,3,4,7,25.0
1970,Erik Melander,Hard,1,2,3,7,33.33
1971,Erik Van Dillen,Carpet,34,60,94,366,36.17
1972,Erik Van Dillen,Clay,42,50,92,366,45.65
1973,Erik Van Dillen,Grass,27,29,56,366,48.21
1974,Erik Van Dillen,Hard,52,72,124,366,41.94
1975,Erik Vant Hof,Hard,1,3,4,4,25.0
1976,Ernesto Aguirre,Clay,3,2,5,5,60.0
1977,Ernesto Escobedo,Clay,3,7,10,44,30.0
1978,Ernesto Escobedo,Grass,2,4,6,44,33.33
1979,Ernesto Escobedo,Hard,10,18,28,44,35.71
1980,Ernesto Lingen,Clay,1,3,4,4,25.0
1981,Ernesto Vazquez,Clay,1,7,8,8,12.5
1982,Ernests Gulbis,Carpet,12,5,17,482,70.59
1983,Ernests Gulbis,Clay,76,69,145,482,52.41
1984,Ernests Gulbis,Grass,15,24,39,482,38.46
1985,Ernests Gulbis,Hard,142,139,281,482,50.53
1986,Ernie Ewert,Clay,7,8,15,42,46.67
1987,Ernie Ewert,Grass,12,15,27,42,44.44
1988,Ernie Fernandez,Hard,9,9,18,18,50.0
1989,Ernie Mccabe,Clay,2,2,4,4,50.0
1990,Ernst Blanke,Clay,3,5,8,8,37.5
1991,Errol Kilov,Hard,1,1,2,2,50.0
1992,Ervin Eleskovic,Clay,2,4,6,6,33.33
1993,Erwin Jager,Clay,2,2,4,4,50.0
1994,Esam Abdulaal,Clay,1,1,2,14,50.0
1995,Esam Abdulaal,Hard,7,5,12,14,58.33
1996,Eugenio Castigliano,Clay,12,11,23,23,52.17
1997,Eugenio Munoz,Clay,3,1,4,4,75.0
1998,Eugenio Rossi,Clay,1,4,5,5,20.0
1999,Eugenius Cariovas,Carpet,1,1,2,2,50.0
2000,Eui Jong Chang,Carpet,1,2,3,25,33.33
2001,Eui Jong Chang,Clay,5,2,7,25,71.43
2002,Eui Jong Chang,Grass,2,2,4,25,50.0
2003,Eui Jong Chang,Hard,2,9,11,25,18.18
2004,Evan King,Hard,1,4,5,5,20.0
2005,Evgeni Mikheev,Carpet,1,2,3,3,33.33
2006,Evgeny Donskoy,Clay,6,23,29,165,20.69
2007,Evgeny Donskoy,Grass,4,11,15,165,26.67
2008,Evgeny Donskoy,Hard,44,77,121,165,36.36
2009,Evgeny Korolev,Carpet,1,3,4,172,25.0
2010,Evgeny Korolev,Clay,24,38,62,172,38.71
2011,Evgeny Korolev,Grass,2,10,12,172,16.67
2012,Evgeny Korolev,Hard,47,47,94,172,50.0
2013,Evghenii Plugariov,Clay,2,3,5,5,40.0
2014,Eyal Erlich,Carpet,1,2,3,17,33.33
2015,Eyal Erlich,Hard,6,8,14,17,42.86
2016,Eyal Ran,Carpet,2,4,6,53,33.33
2017,Eyal Ran,Clay,2,8,10,53,20.0
2018,Eyal Ran,Hard,13,24,37,53,35.14
2019,Ezio Di Matteo,Clay,19,30,49,57,38.78
2020,Ezio Di Matteo,Grass,1,3,4,57,25.0
2021,Ezio Di Matteo,Hard,1,3,4,57,25.0
2022,Ezzat Nemati,Clay,1,3,4,6,25.0
2023,Ezzat Nemati,Hard,1,1,2,6,50.0
2024,Fabio Fognini,Clay,208,148,356,688,58.43
2025,Fabio Fognini,Grass,19,18,37,688,51.35
2026,Fabio Fognini,Hard,142,153,295,688,48.14
2027,Fabio Maggi,Clay,2,4,6,6,33.33
2028,Fabio Silberberg,Hard,1,1,2,2,50.0
2029,Fabrice Santoro,Carpet,48,55,103,914,46.6
2030,Fabrice Santoro,Clay,132,142,274,914,48.18
2031,Fabrice Santoro,Grass,44,33,77,914,57.14
2032,Fabrice Santoro,Hard,246,214,460,914,53.48
2033,Fabrizio Fanucci,Clay,1,5,6,6,16.67
2034,Facundo Arguello,Clay,1,13,14,14,7.14
2035,Facundo Bagnis,Clay,21,37,58,67,36.21
2036,Facundo Bagnis,Hard,1,8,9,67,11.11
2037,Fadel Berthe,Clay,2,2,4,10,50.0
2038,Fadel Berthe,Hard,2,4,6,10,33.33
2039,Faisal Rahman,Hard,1,2,3,3,33.33
2040,Famiano Meneschincheri,Carpet,1,3,4,7,25.0
2041,Famiano Meneschincheri,Clay,1,2,3,7,33.33
2042,Farhad Tadayon,Clay,2,1,3,3,66.67
2043,Farrukh Dustov,Clay,7,11,18,30,38.89
2044,Farrukh Dustov,Hard,4,8,12,30,33.33
2045,Farshad Talavar,Clay,2,1,3,3,66.67
2046,Fazaluddin Syed,Grass,4,2,6,6,66.67
2047,Febi Widhiyanto,Hard,15,8,23,23,65.22
2048,Federico Browne,Clay,9,14,23,31,39.13
2049,Federico Browne,Hard,2,6,8,31,25.0
2050,Federico Coria,Clay,9,8,17,24,52.94
2051,Federico Coria,Hard,2,5,7,24,28.57
2052,Federico Delbonis,Clay,105,86,191,277,54.97
2053,Federico Delbonis,Hard,26,60,86,277,30.23
2054,Federico Dondo,Clay,15,16,31,40,48.39
2055,Federico Dondo,Hard,5,4,9,40,55.56
2056,Federico Gaio,Clay,2,5,7,7,28.57
2057,Federico Luzzi,Carpet,1,2,3,49,33.33
2058,Federico Luzzi,Clay,13,21,34,49,38.24
2059,Federico Luzzi,Hard,4,8,12,49,33.33
2060,Federico Mordegan,Clay,2,9,11,11,18.18
2061,Federico Sanchez,Clay,8,10,18,18,44.44
2062,Federico Sansonetti,Clay,5,4,9,9,55.56
2063,Federico Zeballos,Clay,1,5,6,11,16.67
2064,Federico Zeballos,Hard,2,3,5,11,40.0
2065,Feliciano Lopez,Carpet,11,12,23,957,47.83
2066,Feliciano Lopez,Clay,130,133,263,957,49.43
2067,Feliciano Lopez,Grass,83,43,126,957,65.87
2068,Feliciano Lopez,Hard,275,270,545,957,50.46
2069,Felipe Rivera,Carpet,1,1,2,18,50.0
2070,Felipe Rivera,Clay,3,9,12,18,25.0
2071,Felipe Rivera,Hard,2,2,4,18,50.0
2072,Felix Auger Aliassime,Clay,16,15,31,124,51.61
2073,Felix Auger Aliassime,Grass,9,3,12,124,75.0
2074,Felix Auger Aliassime,Hard,45,36,81,124,55.56
2075,Felix Barrientos,Carpet,2,3,5,28,40.0
2076,Felix Barrientos,Clay,4,1,5,28,80.0
2077,Felix Barrientos,Grass,2,1,3,28,66.67
2078,Felix Barrientos,Hard,12,3,15,28,80.0
2079,Felix Mantilla,Carpet,6,17,23,533,26.09
2080,Felix Mantilla,Clay,236,122,358,533,65.92
2081,Felix Mantilla,Grass,5,10,15,533,33.33
2082,Felix Mantilla,Hard,68,69,137,533,49.64
2083,Felix Ponte,Grass,1,3,4,7,25.0
2084,Felix Ponte,Hard,1,2,3,7,33.33
2085,Ferdi Taygan,Carpet,28,32,60,190,46.67
2086,Ferdi Taygan,Clay,14,36,50,190,28.0
2087,Ferdi Taygan,Grass,9,14,23,190,39.13
2088,Ferdi Taygan,Hard,19,38,57,190,33.33
2089,Ferenc Zentai,Clay,1,3,4,4,25.0
2090,Fernando Dalla Fontana,Clay,11,28,39,39,28.21
2091,Fernando Gentil,Clay,2,6,8,8,25.0
2092,Fernando Gonzalez,Carpet,16,12,28,577,57.14
2093,Fernando Gonzalez,Clay,168,72,240,577,70.0
2094,Fernando Gonzalez,Grass,23,14,37,577,62.16
2095,Fernando Gonzalez,Hard,166,106,272,577,61.03
2096,Fernando Luna,Clay,173,161,334,336,51.8
2097,Fernando Luna,Hard,1,1,2,336,50.0
2098,Fernando Maynetto,Carpet,1,1,2,35,50.0
2099,Fernando Maynetto,Clay,7,20,27,35,25.93
2100,Fernando Maynetto,Hard,2,4,6,35,33.33
2101,Fernando Meligeni,Carpet,3,9,12,420,25.0
2102,Fernando Meligeni,Clay,161,131,292,420,55.14
2103,Fernando Meligeni,Grass,1,6,7,420,14.29
2104,Fernando Meligeni,Hard,38,71,109,420,34.86
2105,Fernando Roese,Carpet,4,7,11,67,36.36
2106,Fernando Roese,Clay,1,10,11,67,9.09
2107,Fernando Roese,Hard,19,26,45,67,42.22
2108,Fernando Samayoa,Hard,2,2,4,4,50.0
2109,Fernando Soler,Clay,3,6,9,9,33.33
2110,Fernando Vasquez,Clay,1,1,2,2,50.0
2111,Fernando Verdasco,Carpet,9,8,17,976,52.94
2112,Fernando Verdasco,Clay,230,147,377,976,61.01
2113,Fernando Verdasco,Grass,51,42,93,976,54.84
2114,Fernando Verdasco,Hard,262,227,489,976,53.58
2115,Fernando Vicente,Carpet,2,9,11,372,18.18
2116,Fernando Vicente,Clay,113,128,241,372,46.89
2117,Fernando Vicente,Grass,5,12,17,372,29.41
2118,Fernando Vicente,Hard,39,64,103,372,37.86
2119,Fernon Wibier,Carpet,5,6,11,39,45.45
2120,Fernon Wibier,Clay,1,5,6,39,16.67
2121,Fernon Wibier,Grass,4,7,11,39,36.36
2122,Fernon Wibier,Hard,4,7,11,39,36.36
2123,Ferrante Rocchi,Clay,1,3,4,4,25.0
2124,Filip Dewulf,Carpet,19,24,43,222,44.19
2125,Filip Dewulf,Clay,50,49,99,222,50.51
2126,Filip Dewulf,Grass,3,9,12,222,25.0
2127,Filip Dewulf,Hard,25,43,68,222,36.76
2128,Filip Horansky,Clay,1,5,6,6,16.67
2129,Filip Krajcik,Carpet,1,2,3,3,33.33
2130,Filip Krajinovic,Clay,18,21,39,162,46.15
2131,Filip Krajinovic,Hard,66,57,123,162,53.66
2132,Filip Peliwo,Clay,1,3,4,8,25.0
2133,Filip Peliwo,Hard,1,3,4,8,25.0
2134,Filip Prpic,Hard,2,5,7,7,28.57
2135,Filip Urban,Clay,1,3,4,4,25.0
2136,Filippo Messori,Clay,2,4,6,6,33.33
2137,Filippo Veglio,Hard,1,2,3,3,33.33
2138,Filippo Volandri,Carpet,2,11,13,403,15.38
2139,Filippo Volandri,Clay,165,144,309,403,53.4
2140,Filippo Volandri,Grass,2,11,13,403,15.38
2141,Filippo Volandri,Hard,9,59,68,403,13.24
2142,Finn Christensen,Clay,2,1,3,3,66.67
2143,Finn Tearney,Hard,1,2,3,3,33.33
2144,Flavio Cipolla,Clay,14,25,39,102,35.9
2145,Flavio Cipolla,Grass,1,7,8,102,12.5
2146,Flavio Cipolla,Hard,21,34,55,102,38.18
2147,Flavio Mazzocchi,Carpet,1,1,2,2,50.0
2148,Flavio Saretta,Carpet,2,3,5,157,40.0
2149,Flavio Saretta,Clay,51,47,98,157,52.04
2150,Flavio Saretta,Grass,6,6,12,157,50.0
2151,Flavio Saretta,Hard,18,24,42,157,42.86
2152,Florent Serra,Carpet,1,6,7,293,14.29
2153,Florent Serra,Clay,48,56,104,293,46.15
2154,Florent Serra,Grass,9,17,26,293,34.62
2155,Florent Serra,Hard,65,91,156,293,41.67
2156,Florian Krumrey,Clay,1,1,2,2,50.0
2157,Florian Mayer,Carpet,3,4,7,507,42.86
2158,Florian Mayer,Clay,100,100,200,507,50.0
2159,Florian Mayer,Grass,39,26,65,507,60.0
2160,Florian Mayer,Hard,101,134,235,507,42.98
2161,Florin Mergea,Clay,2,1,3,5,66.67
2162,Florin Mergea,Grass,1,1,2,5,50.0
2163,Florin Segarceanu,Carpet,8,11,19,136,42.11
2164,Florin Segarceanu,Clay,40,46,86,136,46.51
2165,Florin Segarceanu,Grass,1,4,5,136,20.0
2166,Florin Segarceanu,Hard,10,16,26,136,38.46
2167,Fotis Vazeos,Clay,3,2,5,5,60.0
2168,Frances Tiafoe,Clay,10,19,29,164,34.48
2169,Frances Tiafoe,Grass,6,7,13,164,46.15
2170,Frances Tiafoe,Hard,54,68,122,164,44.26
2171,Francesco Aldi,Clay,1,7,8,8,12.5
2172,Francesco Cancellotti,Clay,111,98,209,224,53.11
2173,Francesco Cancellotti,Hard,5,10,15,224,33.33
2174,Francis Casey Alcantara,Clay,4,2,6,9,66.67
2175,Francis Casey Alcantara,Hard,2,1,3,9,66.67
2176,Francisco Cabello,Clay,2,5,7,7,28.57
2177,Francisco Cerundolo,Clay,1,3,4,4,25.0
2178,Francisco Clavet,Carpet,9,20,29,731,31.03
2179,Francisco Clavet,Clay,266,194,460,731,57.83
2180,Francisco Clavet,Grass,11,11,22,731,50.0
2181,Francisco Clavet,Hard,105,115,220,731,47.73
2182,Francisco Costa,Clay,1,3,4,4,25.0
2183,Francisco Ferrer,Clay,1,2,3,3,33.33
2184,Francisco Fogues,Clay,1,2,3,3,33.33
2185,Francisco Gonzalez,Carpet,22,33,55,286,40.0
2186,Francisco Gonzalez,Clay,28,51,79,286,35.44
2187,Francisco Gonzalez,Grass,17,26,43,286,39.53
2188,Francisco Gonzalez,Hard,46,63,109,286,42.2
2189,Francisco Maciel,Clay,36,38,74,104,48.65
2190,Francisco Maciel,Hard,14,16,30,104,46.67
2191,Francisco Montana,Carpet,2,2,4,54,50.0
2192,Francisco Montana,Clay,11,15,26,54,42.31
2193,Francisco Montana,Grass,1,4,5,54,20.0
2194,Francisco Montana,Hard,3,16,19,54,15.79
2195,Francisco Rodriguez,Clay,12,4,16,20,75.0
2196,Francisco Rodriguez,Hard,2,2,4,20,50.0
2197,Francisco Roig,Carpet,5,6,11,160,45.45
2198,Francisco Roig,Clay,43,68,111,160,38.74
2199,Francisco Roig,Grass,1,1,2,160,50.0
2200,Francisco Roig,Hard,15,21,36,160,41.67
2201,Francisco Truchi,Clay,2,5,7,7,28.57
2202,Francisco Yunis,Clay,27,37,64,64,42.19
2203,Franco Bartoni,Clay,4,9,13,13,30.77
2204,Franco Davin,Clay,152,147,299,308,50.84
2205,Franco Davin,Hard,2,7,9,308,22.22
2206,Franco Ferreiro,Clay,3,4,7,7,42.86
2207,Franco Merlone,Carpet,1,2,3,8,33.33
2208,Franco Merlone,Clay,3,2,5,8,60.0
2209,Franco Squillari,Carpet,1,5,6,321,16.67
2210,Franco Squillari,Clay,129,110,239,321,53.97
2211,Franco Squillari,Grass,1,6,7,321,14.29
2212,Franco Squillari,Hard,25,44,69,321,36.23
2213,Francois Jauffret,Carpet,2,3,5,330,40.0
2214,Francois Jauffret,Clay,181,109,290,330,62.41
2215,Francois Jauffret,Grass,9,13,22,330,40.91
2216,Francois Jauffret,Hard,4,9,13,330,30.77
2217,Francois Van Der Merwe,Grass,3,1,4,4,75.0
2218,Frank Arthur Sedgman,Grass,10,8,18,21,55.56
2219,Frank Arthur Sedgman,Hard,2,1,3,21,66.67
2220,Frank Baden,Clay,1,1,2,2,50.0
2221,Frank Briscoe,Hard,1,2,3,3,33.33
2222,Frank Dancevic,Carpet,6,3,9,178,66.67
2223,Frank Dancevic,Clay,1,18,19,178,5.26
2224,Frank Dancevic,Grass,21,23,44,178,47.73
2225,Frank Dancevic,Hard,40,66,106,178,37.74
2226,Frank Falderbaum,Clay,4,5,9,11,44.44
2227,Frank Falderbaum,Hard,1,1,2,11,50.0
2228,Frank Froehling,Carpet,7,25,32,186,21.88
2229,Frank Froehling,Clay,30,31,61,186,49.18
2230,Frank Froehling,Grass,5,8,13,186,38.46
2231,Frank Froehling,Hard,36,44,80,186,45.0
2232,Frank Gebert,Carpet,6,8,14,108,42.86
2233,Frank Gebert,Clay,26,46,72,108,36.11
2234,Frank Gebert,Grass,4,5,9,108,44.44
2235,Frank Gebert,Hard,4,9,13,108,30.77
2236,Frank McDonald,Hard,1,5,6,6,16.67
2237,Frank Ofori,Carpet,1,3,4,34,25.0
2238,Frank Ofori,Clay,1,4,5,34,20.0
2239,Frank Ofori,Hard,19,6,25,34,76.0
2240,Frank Saloman,Hard,1,1,2,2,50.0
2241,Frank Schmitz,Hard,1,1,2,2,50.0
2242,Frank Sebaratnam,Clay,2,3,5,5,40.0
2243,Frank Sedgman,Clay,3,5,8,25,37.5
2244,Frank Sedgman,Grass,5,8,13,25,38.46
2245,Frank Sedgman,Hard,1,3,4,25,25.0
2246,Frank Tutvin,Clay,1,5,6,6,16.67
2247,Franklin Robbins,Carpet,1,1,2,20,50.0
2248,Franklin Robbins,Clay,1,9,10,20,10.0
2249,Franklin Robbins,Grass,4,4,8,20,50.0
2250,Franko Skugor,Clay,4,11,15,28,26.67
2251,Franko Skugor,Hard,4,9,13,28,30.77
2252,Frantisek Cermak,Clay,8,11,19,21,42.11
2253,Frantisek Cermak,Grass,1,1,2,21,50.0
2254,Frantisek Pala,Carpet,4,16,20,193,20.0
2255,Frantisek Pala,Clay,62,79,141,193,43.97
2256,Frantisek Pala,Grass,3,9,12,193,25.0
2257,Frantisek Pala,Hard,6,14,20,193,30.0
2258,Fred Hemmes,Clay,1,5,6,16,16.67
2259,Fred Hemmes,Hard,4,6,10,16,40.0
2260,Fred Kangwa,Clay,3,3,6,8,50.0
2261,Fred Kangwa,Hard,1,1,2,8,50.0
2262,Fred Mcnair,Carpet,19,39,58,221,32.76
2263,Fred Mcnair,Clay,25,58,83,221,30.12
2264,Fred Mcnair,Grass,14,21,35,221,40.0
2265,Fred Mcnair,Hard,9,36,45,221,20.0
2266,Fred Stolle,Carpet,19,32,51,254,37.25
2267,Fred Stolle,Clay,36,28,64,254,56.25
2268,Fred Stolle,Grass,44,21,65,254,67.69
2269,Fred Stolle,Hard,36,38,74,254,48.65
2270,Freddie De Jesus,Hard,2,4,6,6,33.33
2271,Freddie Sauer,Carpet,3,2,5,55,60.0
2272,Freddie Sauer,Clay,7,14,21,55,33.33
2273,Freddie Sauer,Grass,1,3,4,55,25.0
2274,Freddie Sauer,Hard,13,12,25,55,52.0
2275,Frederic Fontang,Carpet,1,5,6,87,16.67
2276,Frederic Fontang,Clay,25,46,71,87,35.21
2277,Frederic Fontang,Hard,2,8,10,87,20.0
2278,Frederic Niemeyer,Carpet,4,1,5,45,80.0
2279,Frederic Niemeyer,Clay,4,7,11,45,36.36
2280,Frederic Niemeyer,Grass,1,2,3,45,33.33
2281,Frederic Niemeyer,Hard,4,22,26,45,15.38
2282,Frederic Vitoux,Clay,1,5,6,11,16.67
2283,Frederic Vitoux,Hard,1,4,5,11,20.0
2284,Frederick Sletting Johnsen,Hard,1,2,3,3,33.33
2285,Frederick Ted Schroeder,Hard,1,1,2,2,50.0
2286,Frederico Ferreira Silva,Clay,2,4,6,11,33.33
2287,Frederico Ferreira Silva,Hard,1,4,5,11,20.0
2288,Frederico Gil,Carpet,1,1,2,143,50.0
2289,Frederico Gil,Clay,46,38,84,143,54.76
2290,Frederico Gil,Grass,1,7,8,143,12.5
2291,Frederico Gil,Hard,19,30,49,143,38.78
2292,Frederik Fetterlein,Carpet,14,24,38,110,36.84
2293,Frederik Fetterlein,Clay,11,27,38,110,28.95
2294,Frederik Fetterlein,Grass,4,5,9,110,44.44
2295,Frederik Fetterlein,Hard,12,13,25,110,48.0
2296,Frederik Nielsen,Carpet,4,2,6,49,66.67
2297,Frederik Nielsen,Clay,3,7,10,49,30.0
2298,Frederik Nielsen,Hard,15,18,33,49,45.45
2299,Fredrik Jonsson,Carpet,1,1,2,34,50.0
2300,Fredrik Jonsson,Clay,1,9,10,34,10.0
2301,Fredrik Jonsson,Hard,6,16,22,34,27.27
2302,Fredrik Rosenquist,Clay,1,3,4,4,25.0
2303,Frew Mcmillan,Carpet,43,60,103,403,41.75
2304,Frew Mcmillan,Clay,44,63,107,403,41.12
2305,Frew Mcmillan,Grass,32,33,65,403,49.23
2306,Frew Mcmillan,Hard,54,74,128,403,42.19
2307,Frithjof Prydz,Clay,2,7,9,9,22.22
2308,Fritz Buehning,Carpet,41,43,84,235,48.81
2309,Fritz Buehning,Clay,5,12,17,235,29.41
2310,Fritz Buehning,Grass,22,18,40,235,55.0
2311,Fritz Buehning,Hard,46,48,94,235,48.94
2312,Fritz Wolmarans,Clay,1,1,2,8,50.0
2313,Fritz Wolmarans,Hard,3,3,6,8,50.0
2314,G Turner Howard,Clay,4,5,9,16,44.44
2315,G Turner Howard,Hard,1,6,7,16,14.29
2316,Gabor Borsos,Hard,1,2,3,3,33.33
2317,Gabriel Auroux,Clay,1,1,2,2,50.0
2318,Gabriel Flores Ruiz,Hard,1,4,5,5,20.0
2319,Gabriel Markus,Carpet,2,5,7,130,28.57
2320,Gabriel Markus,Clay,47,48,95,130,49.47
2321,Gabriel Markus,Hard,10,18,28,130,35.71
2322,Gabriel Mattos,Clay,1,2,3,3,33.33
2323,Gabriel Monroy,Clay,1,1,2,2,50.0
2324,Gabriel Montilla,Hard,2,2,4,4,50.0
2325,Gabriel Silberstein,Clay,10,11,21,23,47.62
2326,Gabriel Silberstein,Hard,1,1,2,23,50.0
2327,Gabriel Trifu,Clay,4,8,12,12,33.33
2328,Gabriel Trujillo Soler,Clay,1,1,2,2,50.0
2329,Gabriel Urpi,Clay,42,65,107,110,39.25
2330,Gabriel Urpi,Hard,1,2,3,110,33.33
2331,Gael Monfils,Carpet,6,4,10,778,60.0
2332,Gael Monfils,Clay,128,84,212,778,60.38
2333,Gael Monfils,Grass,40,29,69,778,57.97
2334,Gael Monfils,Hard,319,168,487,778,65.5
2335,Gaetano Di Maso,Clay,2,3,5,5,40.0
2336,Galo Blanco,Clay,111,126,237,293,46.84
2337,Galo Blanco,Grass,1,6,7,293,14.29
2338,Galo Blanco,Hard,10,39,49,293,20.41
2339,Garth Thomson,Hard,2,2,4,4,50.0
2340,Gary Donnelly,Hard,13,20,33,33,39.39
2341,Gary Drake,Grass,1,1,2,2,50.0
2342,Gary Lemon,Hard,1,1,2,2,50.0
2343,Gary Muller,Carpet,10,14,24,203,41.67
2344,Gary Muller,Clay,4,6,10,203,40.0
2345,Gary Muller,Grass,18,24,42,203,42.86
2346,Gary Muller,Hard,53,74,127,203,41.73
2347,Gary Penberthy,Grass,1,2,3,3,33.33
2348,Gary Thoroughood,Hard,1,1,2,2,50.0
2349,Gastao Elias,Clay,23,29,52,78,44.23
2350,Gastao Elias,Hard,4,22,26,78,15.38
2351,Gaston Etlis,Carpet,2,2,4,85,50.0
2352,Gaston Etlis,Clay,14,36,50,85,28.0
2353,Gaston Etlis,Hard,14,17,31,85,45.16
2354,Gaston Gaudio,Carpet,10,15,25,468,40.0
2355,Gaston Gaudio,Clay,212,109,321,468,66.04
2356,Gaston Gaudio,Grass,2,6,8,468,25.0
2357,Gaston Gaudio,Hard,48,66,114,468,42.11
2358,Gaurav Misra,Clay,2,2,4,4,50.0
2359,Gavaskar Williams,Hard,1,3,4,4,25.0
2360,Gavorielle Marcu,Hard,1,7,8,8,12.5
2361,Gd Jones,Hard,7,1,8,8,87.5
2362,Gehad El Deeb,Hard,1,1,2,2,50.0
2363,Genaro Deleon,Clay,7,11,18,23,38.89
2364,Genaro Deleon,Hard,2,3,5,23,40.0
2365,Gene Mayer,Carpet,105,53,158,475,66.46
2366,Gene Mayer,Clay,80,52,132,475,60.61
2367,Gene Mayer,Grass,15,13,28,475,53.57
2368,Gene Mayer,Hard,116,41,157,475,73.89
2369,Gene Scott,Grass,19,17,36,48,52.78
2370,Gene Scott,Hard,4,8,12,48,33.33
2371,Gene Stuart Malin,Carpet,1,8,9,41,11.11
2372,Gene Stuart Malin,Clay,1,3,4,41,25.0
2373,Gene Stuart Malin,Grass,1,2,3,41,33.33
2374,Gene Stuart Malin,Hard,8,17,25,41,32.0
2375,Genius Chidzikwe,Clay,1,5,6,18,16.67
2376,Genius Chidzikwe,Hard,2,10,12,18,16.67
2377,Geoff Bluett,Grass,1,1,2,2,50.0
2378,Geoff Grant,Clay,1,2,3,26,33.33
2379,Geoff Grant,Hard,7,16,23,26,30.43
2380,Geoff Masters,Carpet,36,53,89,468,40.45
2381,Geoff Masters,Clay,62,61,123,468,50.41
2382,Geoff Masters,Grass,57,59,116,468,49.14
2383,Geoff Masters,Hard,70,70,140,468,50.0
2384,Geoff Pollard,Grass,2,3,5,5,40.0
2385,Geoff Stubbs,Grass,1,1,2,2,50.0
2386,Geoffery Newton,Hard,1,1,2,2,50.0
2387,George Amaya,Clay,3,4,7,16,42.86
2388,George Amaya,Grass,2,1,3,16,66.67
2389,George Amaya,Hard,1,5,6,16,16.67
2390,George Bastl,Carpet,6,12,18,143,33.33
2391,George Bastl,Clay,4,14,18,143,22.22
2392,George Bastl,Grass,3,13,16,143,18.75
2393,George Bastl,Hard,37,54,91,143,40.66
2394,George Berner,Clay,2,4,6,6,33.33
2395,George Bezecny,Clay,2,5,7,7,28.57
2396,George Cosac,Carpet,1,2,3,10,33.33
2397,George Cosac,Clay,1,6,7,10,14.29
2398,George Hardie,Carpet,18,28,46,220,39.13
2399,George Hardie,Clay,21,50,71,220,29.58
2400,George Hardie,Grass,11,24,35,220,31.43
2401,George Hardie,Hard,26,42,68,220,38.24
2402,George Kalovelonis,Clay,19,31,50,50,38.0
2403,George Rudman,Hard,3,8,11,11,27.27
2404,George Taylor,Grass,1,5,6,12,16.67
2405,George Taylor,Hard,1,5,6,12,16.67
2406,Georges Goven,Carpet,11,13,24,411,45.83
2407,Georges Goven,Clay,122,148,270,411,45.19
2408,Georges Goven,Grass,21,24,45,411,46.67
2409,Georges Goven,Hard,34,38,72,411,47.22
2410,Gerald Battrick,Carpet,18,34,52,302,34.62
2411,Gerald Battrick,Clay,58,73,131,302,44.27
2412,Gerald Battrick,Grass,18,22,40,302,45.0
2413,Gerald Battrick,Hard,37,42,79,302,46.84
2414,Gerald Mandl,Clay,3,5,8,8,37.5
2415,Gerald Marzenell,Clay,1,1,2,2,50.0
2416,Gerald Melzer,Clay,16,21,37,52,43.24
2417,Gerald Melzer,Hard,2,13,15,52,13.33
2418,Gerald Mild,Clay,2,3,5,5,40.0
2419,Gerald Pilet,Clay,1,1,2,2,50.0
2420,Gerard Solves,Carpet,2,2,4,56,50.0
2421,Gerard Solves,Clay,12,29,41,56,29.27
2422,Gerard Solves,Hard,7,4,11,56,63.64
2423,Gerard Toulon,Clay,2,3,5,5,40.0
2424,Gerard Wimmer,Grass,2,2,4,4,50.0
2425,Gerardo Lopez Villasenor,Clay,2,2,4,7,50.0
2426,Gerardo Lopez Villasenor,Hard,1,2,3,7,33.33
2427,Gerardo Mirad,Clay,1,1,2,2,50.0
2428,Gerardo Vacarezza,Clay,2,1,3,3,66.67
2429,Gergely Kisgyorgy,Carpet,1,5,6,15,16.67
2430,Gergely Kisgyorgy,Hard,5,4,9,15,55.56
2431,German Lopez,Clay,29,33,62,75,46.77
2432,German Lopez,Hard,3,10,13,75,23.08
2433,German Puentes,Clay,11,22,33,41,33.33
2434,German Puentes,Grass,1,1,2,41,50.0
2435,German Puentes,Hard,1,5,6,41,16.67
2436,Gerry Perry,Grass,1,2,3,3,33.33
2437,Geza Varga,Clay,6,14,20,29,30.0
2438,Geza Varga,Hard,5,4,9,29,55.56
2439,Gian Marco Moroni,Clay,1,1,2,2,50.0
2440,Gianluca Mager,Clay,5,7,12,20,41.67
2441,Gianluca Mager,Hard,3,5,8,20,37.5
2442,Gianluca Naso,Clay,3,11,14,14,21.43
2443,Gianluca Pozzi,Carpet,31,40,71,434,43.66
2444,Gianluca Pozzi,Clay,6,35,41,434,14.63
2445,Gianluca Pozzi,Grass,32,36,68,434,47.06
2446,Gianluca Pozzi,Hard,106,148,254,434,41.73
2447,Gianluca Rinaldini,Carpet,2,5,7,33,28.57
2448,Gianluca Rinaldini,Clay,7,19,26,33,26.92
2449,Gianluigi Quinzi,Clay,1,1,2,2,50.0
2450,Gianni Marchetti,Carpet,1,2,3,3,33.33
2451,Gianni Mina,Clay,1,4,5,5,20.0
2452,Gianni Ocleppo,Carpet,26,23,49,231,53.06
2453,Gianni Ocleppo,Clay,46,69,115,231,40.0
2454,Gianni Ocleppo,Grass,5,9,14,231,35.71
2455,Gianni Ocleppo,Hard,26,27,53,231,49.06
2456,Gil Kovalski,Hard,1,2,3,3,33.33
2457,Gilad Bloom,Carpet,9,14,23,215,39.13
2458,Gilad Bloom,Clay,10,30,40,215,25.0
2459,Gilad Bloom,Grass,10,12,22,215,45.45
2460,Gilad Bloom,Hard,64,66,130,215,49.23
2461,Gilbert Schaller,Carpet,2,6,8,245,25.0
2462,Gilbert Schaller,Clay,103,96,199,245,51.76
2463,Gilbert Schaller,Hard,10,28,38,245,26.32
2464,Gilles Bastie,Hard,1,2,3,3,33.33
2465,Gilles Elseneer,Carpet,4,3,7,42,57.14
2466,Gilles Elseneer,Clay,1,2,3,42,33.33
2467,Gilles Elseneer,Grass,9,11,20,42,45.0
2468,Gilles Elseneer,Hard,4,8,12,42,33.33
2469,Gilles Ganancia,Clay,10,8,18,20,55.56
2470,Gilles Ganancia,Hard,1,1,2,20,50.0
2471,Gilles Kremer,Clay,1,6,7,25,14.29
2472,Gilles Kremer,Hard,7,11,18,25,38.89
2473,Gilles Moretton,Carpet,2,8,10,152,20.0
2474,Gilles Moretton,Clay,35,51,86,152,40.7
2475,Gilles Moretton,Grass,4,10,14,152,28.57
2476,Gilles Moretton,Hard,18,24,42,152,42.86
2477,Gilles Muller,Carpet,3,6,9,443,33.33
2478,Gilles Muller,Clay,27,32,59,443,45.76
2479,Gilles Muller,Grass,45,36,81,443,55.56
2480,Gilles Muller,Hard,155,139,294,443,52.72
2481,Gilles Simon,Carpet,4,7,11,871,36.36
2482,Gilles Simon,Clay,146,112,258,871,56.59
2483,Gilles Simon,Grass,52,38,90,871,57.78
2484,Gilles Simon,Hard,295,217,512,871,57.62
2485,Giordano Maioli,Clay,5,4,9,9,55.56
2486,Giorgio Carneade,Clay,1,4,5,5,20.0
2487,Giorgio Galimberti,Clay,6,12,18,27,33.33
2488,Giorgio Galimberti,Hard,3,6,9,27,33.33
2489,Giovanni Capozza,Clay,1,1,2,2,50.0
2490,Giovanni Lapentti,Clay,6,19,25,55,24.0
2491,Giovanni Lapentti,Grass,2,4,6,55,33.33
2492,Giovanni Lapentti,Hard,11,13,24,55,45.83
2493,Girts Dzelde,Carpet,5,5,10,37,50.0
2494,Girts Dzelde,Clay,9,11,20,37,45.0
2495,Girts Dzelde,Hard,2,5,7,37,28.57
2496,Giuseppe Merlo,Clay,4,9,13,13,30.77
2497,Givaldo Barbosa,Carpet,1,5,6,51,16.67
2498,Givaldo Barbosa,Clay,6,24,30,51,20.0
2499,Givaldo Barbosa,Hard,6,9,15,51,40.0
2500,Givi Samkharadze,Clay,1,3,4,4,25.0
2501,Gleb Sakharov,Clay,1,1,2,2,50.0
2502,Glen Holroyd,Carpet,1,2,3,22,33.33
2503,Glen Holroyd,Clay,2,4,6,22,33.33
2504,Glen Holroyd,Grass,1,4,5,22,20.0
2505,Glen Holroyd,Hard,1,7,8,22,12.5
2506,Glenn Layendecker,Carpet,14,21,35,181,40.0
2507,Glenn Layendecker,Clay,3,9,12,181,25.0
2508,Glenn Layendecker,Grass,19,24,43,181,44.19
2509,Glenn Layendecker,Hard,41,50,91,181,45.05
2510,Glenn Michibata,Carpet,15,23,38,195,39.47
2511,Glenn Michibata,Clay,5,12,17,195,29.41
2512,Glenn Michibata,Grass,9,16,25,195,36.0
2513,Glenn Michibata,Hard,45,70,115,195,39.13
2514,Glenn Petrovic,Grass,1,1,2,10,50.0
2515,Glenn Petrovic,Hard,1,7,8,10,12.5
2516,Glenn Weiner,Grass,2,3,5,38,40.0
2517,Glenn Weiner,Hard,11,22,33,38,33.33
2518,Go Soeda,Carpet,9,3,12,146,75.0
2519,Go Soeda,Clay,4,9,13,146,30.77
2520,Go Soeda,Grass,4,13,17,146,23.53
2521,Go Soeda,Hard,38,66,104,146,36.54
2522,Gondo Widjojo,Hard,2,2,4,4,50.0
2523,Gonzales Austin,Hard,1,1,2,2,50.0
2524,Gonzalo Escobar,Clay,1,4,5,5,20.0
2525,Gonzalo Lama,Clay,7,2,9,9,77.78
2526,Goran Ivanisevic,Carpet,192,75,267,937,71.91
2527,Goran Ivanisevic,Clay,141,87,228,937,61.84
2528,Goran Ivanisevic,Grass,71,28,99,937,71.72
2529,Goran Ivanisevic,Hard,200,143,343,937,58.31
2530,Goran Prpic,Carpet,16,25,41,247,39.02
2531,Goran Prpic,Clay,96,76,172,247,55.81
2532,Goran Prpic,Grass,1,5,6,247,16.67
2533,Goran Prpic,Hard,13,15,28,247,46.43
2534,Goran Tosic,Clay,1,3,4,4,25.0
2535,Gordon Asciak,Hard,1,7,8,8,12.5
2536,Gordon Jones,Carpet,1,1,2,2,50.0
2537,Gorka Fraile,Clay,1,7,8,8,12.5
2538,Goudjo Gbedey,Hard,5,1,6,6,83.33
2539,Gouichi Motomura,Carpet,9,6,15,76,60.0
2540,Gouichi Motomura,Clay,2,4,6,76,33.33
2541,Gouichi Motomura,Grass,2,4,6,76,33.33
2542,Gouichi Motomura,Hard,18,31,49,76,36.73
2543,Graeme Thomson,Carpet,1,1,2,22,50.0
2544,Graeme Thomson,Clay,1,2,3,22,33.33
2545,Graeme Thomson,Grass,5,12,17,22,29.41
2546,Graham Oliver,Grass,1,2,3,3,33.33
2547,Graham Stilwell,Carpet,19,46,65,245,29.23
2548,Graham Stilwell,Clay,25,49,74,245,33.78
2549,Graham Stilwell,Grass,24,25,49,245,48.98
2550,Graham Stilwell,Hard,17,40,57,245,29.82
2551,Grant Connell,Carpet,13,15,28,172,46.43
2552,Grant Connell,Grass,7,12,19,172,36.84
2553,Grant Connell,Hard,55,70,125,172,44.0
2554,Grant Doyle,Hard,4,18,22,22,18.18
2555,Grant Stafford,Carpet,3,12,15,201,20.0
2556,Grant Stafford,Clay,7,14,21,201,33.33
2557,Grant Stafford,Grass,20,20,40,201,50.0
2558,Grant Stafford,Hard,53,72,125,201,42.4
2559,Graydon Garner,Clay,1,2,3,19,33.33
2560,Graydon Garner,Grass,3,2,5,19,60.0
2561,Graydon Garner,Hard,3,8,11,19,27.27
2562,Greg Amaya,Clay,1,2,3,3,33.33
2563,Greg Cooper,Grass,3,2,5,5,60.0
2564,Greg Failla,Hard,1,4,5,5,20.0
2565,Greg Halder,Clay,6,11,17,27,35.29
2566,Greg Halder,Hard,2,8,10,27,20.0
2567,Greg Holmes,Carpet,11,19,30,176,36.67
2568,Greg Holmes,Clay,1,8,9,176,11.11
2569,Greg Holmes,Grass,11,16,27,176,40.74
2570,Greg Holmes,Hard,60,50,110,176,54.55
2571,Greg Jones,Hard,1,5,6,6,16.67
2572,Greg Perkins,Grass,7,11,18,26,38.89
2573,Greg Perkins,Hard,2,6,8,26,25.0
2574,Greg Rusedski,Carpet,91,43,134,728,67.91
2575,Greg Rusedski,Clay,30,51,81,728,37.04
2576,Greg Rusedski,Grass,86,36,122,728,70.49
2577,Greg Rusedski,Hard,231,160,391,728,59.08
2578,Greg Van Emburgh,Hard,2,1,3,3,66.67
2579,Greg Whitecross,Carpet,2,3,5,34,40.0
2580,Greg Whitecross,Grass,8,21,29,34,27.59
2581,Grega Zemlja,Carpet,4,1,5,97,80.0
2582,Grega Zemlja,Clay,14,14,28,97,50.0
2583,Grega Zemlja,Grass,8,7,15,97,53.33
2584,Grega Zemlja,Hard,20,29,49,97,40.82
2585,Gregoire Barrere,Clay,1,5,6,34,16.67
2586,Gregoire Barrere,Grass,1,2,3,34,33.33
2587,Gregoire Barrere,Hard,9,16,25,34,36.0
2588,Gregoire Rafaitin,Clay,3,9,12,14,25.0
2589,Gregoire Rafaitin,Hard,1,1,2,14,50.0
2590,Gregory Carraz,Carpet,5,6,11,85,45.45
2591,Gregory Carraz,Grass,6,9,15,85,40.0
2592,Gregory Carraz,Hard,24,35,59,85,40.68
2593,Greig Rodger,Hard,5,7,12,12,41.67
2594,Grigor Dimitrov,Clay,71,50,121,543,58.68
2595,Grigor Dimitrov,Grass,36,26,62,543,58.06
2596,Grigor Dimitrov,Hard,222,138,360,543,61.67
2597,Grover Raz Reid,Carpet,12,18,30,131,40.0
2598,Grover Raz Reid,Clay,8,24,32,131,25.0
2599,Grover Raz Reid,Grass,9,15,24,131,37.5
2600,Grover Raz Reid,Hard,16,29,45,131,35.56
2601,Grzegorz Panfil,Hard,1,1,2,2,50.0
2602,Guido Andreozzi,Clay,5,14,19,36,26.32
2603,Guido Andreozzi,Grass,1,3,4,36,25.0
2604,Guido Andreozzi,Hard,5,8,13,36,38.46
2605,Guido Pella,Clay,61,51,112,236,54.46
2606,Guido Pella,Grass,8,10,18,236,44.44
2607,Guido Pella,Hard,44,62,106,236,41.51
2608,Guilherme Clezar,Clay,1,11,12,12,8.33
2609,Guillaume Couillard,Clay,2,7,9,9,22.22
2610,Guillaume Raoux,Carpet,47,49,96,404,48.96
2611,Guillaume Raoux,Clay,15,37,52,404,28.85
2612,Guillaume Raoux,Grass,21,27,48,404,43.75
2613,Guillaume Raoux,Hard,96,112,208,404,46.15
2614,Guillaume Rufin,Clay,5,13,18,44,27.78
2615,Guillaume Rufin,Grass,2,4,6,44,33.33
2616,Guillaume Rufin,Hard,9,11,20,44,45.0
2617,Guillermo Aubone,Clay,10,29,39,47,25.64
2618,Guillermo Aubone,Hard,2,6,8,47,25.0
2619,Guillermo Canas,Carpet,7,12,19,450,36.84
2620,Guillermo Canas,Clay,124,86,210,450,59.05
2621,Guillermo Canas,Grass,26,18,44,450,59.09
2622,Guillermo Canas,Hard,98,79,177,450,55.37
2623,Guillermo Coria,Carpet,7,7,14,335,50.0
2624,Guillermo Coria,Clay,134,53,187,335,71.66
2625,Guillermo Coria,Grass,10,8,18,335,55.56
2626,Guillermo Coria,Hard,68,48,116,335,58.62
2627,Guillermo Garcia Lopez,Carpet,1,3,4,653,25.0
2628,Guillermo Garcia Lopez,Clay,136,138,274,653,49.64
2629,Guillermo Garcia Lopez,Grass,29,31,60,653,48.33
2630,Guillermo Garcia Lopez,Hard,133,182,315,653,42.22
2631,Guillermo Olaso,Clay,2,3,5,5,40.0
2632,Guillermo Oropez,Clay,1,1,2,2,50.0
2633,Guillermo Perez Roldan,Clay,234,120,354,375,66.1
2634,Guillermo Perez Roldan,Hard,7,14,21,375,33.33
2635,Guillermo Rivas,Carpet,2,1,3,37,66.67
2636,Guillermo Rivas,Clay,7,22,29,37,24.14
2637,Guillermo Rivas,Hard,1,4,5,37,20.0
2638,Guillermo Vilas,Carpet,89,47,136,1228,65.44
2639,Guillermo Vilas,Clay,667,170,837,1228,79.69
2640,Guillermo Vilas,Grass,70,26,96,1228,72.92
2641,Guillermo Vilas,Hard,110,49,159,1228,69.18
2642,Gunther Darkey,Hard,2,2,4,4,50.0
2643,Gunther Gnettner,Clay,1,5,6,6,16.67
2644,Gustavo Garetto,Clay,3,5,8,8,37.5
2645,Gustavo Giussani,Clay,8,17,25,25,32.0
2646,Gustavo Guerrero,Clay,7,22,29,29,24.14
2647,Gustavo Kuerten,Carpet,24,20,44,556,54.55
2648,Gustavo Kuerten,Clay,183,78,261,556,70.11
2649,Gustavo Kuerten,Grass,7,8,15,556,46.67
2650,Gustavo Kuerten,Hard,147,89,236,556,62.29
2651,Gustavo Luza,Clay,1,4,5,5,20.0
2652,Gustavo Marcaccio,Clay,2,2,4,4,50.0
2653,Gustavo Ramirez,Clay,3,5,8,11,37.5
2654,Gustavo Ramirez,Hard,1,2,3,11,33.33
2655,Gustavo Tiberti,Carpet,1,1,2,41,50.0
2656,Gustavo Tiberti,Clay,11,25,36,41,30.56
2657,Gustavo Tiberti,Hard,1,2,3,41,33.33
2658,Guy Forget,Carpet,89,73,162,672,54.94
2659,Guy Forget,Clay,99,91,190,672,52.11
2660,Guy Forget,Grass,46,32,78,672,58.97
2661,Guy Forget,Hard,147,95,242,672,60.74
2662,Gyorgy Balazs,Clay,2,1,3,3,66.67
2663,Hachiro Shibata,Clay,1,1,2,2,50.0
2664,Hady Habib,Clay,1,3,4,4,25.0
2665,Haithem Abid,Clay,1,5,6,6,16.67
2666,Hajime Nihonmatsu,Hard,1,1,2,2,50.0
2667,Hakar Zahr,Clay,3,8,11,15,27.27
2668,Hakar Zahr,Hard,1,3,4,15,25.0
2669,Hamed Ul Haq,Clay,13,3,16,28,81.25
2670,Hamed Ul Haq,Hard,6,6,12,28,50.0
2671,Han Cheol Shin,Clay,2,3,5,12,40.0
2672,Han Cheol Shin,Hard,2,5,7,12,28.57
2673,Hani Al Ali,Hard,5,6,11,11,45.45
2674,Hank Pfister,Carpet,47,56,103,474,45.63
2675,Hank Pfister,Clay,22,30,52,474,42.31
2676,Hank Pfister,Grass,96,53,149,474,64.43
2677,Hank Pfister,Hard,96,74,170,474,56.47
2678,Hans Dieter Beutel,Carpet,9,9,18,64,50.0
2679,Hans Dieter Beutel,Clay,6,22,28,64,21.43
2680,Hans Dieter Beutel,Grass,1,2,3,64,33.33
2681,Hans Dieter Beutel,Hard,3,12,15,64,20.0
2682,Hans Engert,Clay,3,9,12,12,25.0
2683,Hans Gildemeister,Carpet,5,7,12,349,41.67
2684,Hans Gildemeister,Clay,197,122,319,349,61.76
2685,Hans Gildemeister,Grass,1,2,3,349,33.33
2686,Hans Gildemeister,Hard,3,12,15,349,20.0
2687,Hans Hach Verdugo,Hard,1,1,2,2,50.0
2688,Hans Hansson,Grass,1,3,4,4,25.0
2689,Hans Joachim Ploetz,Carpet,1,5,6,121,16.67
2690,Hans Joachim Ploetz,Clay,32,51,83,121,38.55
2691,Hans Joachim Ploetz,Grass,9,15,24,121,37.5
2692,Hans Joachim Ploetz,Hard,2,6,8,121,25.0
2693,Hans Jurgen Pohmann,Carpet,10,16,26,235,38.46
2694,Hans Jurgen Pohmann,Clay,77,73,150,235,51.33
2695,Hans Jurgen Pohmann,Grass,4,10,14,235,28.57
2696,Hans Jurgen Pohmann,Hard,26,19,45,235,57.78
2697,Hans Kary,Carpet,10,21,31,369,32.26
2698,Hans Kary,Clay,102,145,247,369,41.3
2699,Hans Kary,Grass,6,15,21,369,28.57
2700,Hans Kary,Hard,31,39,70,369,44.29
2701,Hans Nerell,Clay,5,8,13,15,38.46
2702,Hans Nerell,Hard,1,1,2,15,50.0
2703,Hans Peter Kandler,Clay,5,15,20,27,25.0
2704,Hans Peter Kandler,Hard,2,5,7,27,28.57
2705,Hans Podlipnik Castillo,Clay,3,3,6,6,50.0
2706,Hans Schwaier,Clay,52,70,122,151,42.62
2707,Hans Schwaier,Grass,3,3,6,151,50.0
2708,Hans Schwaier,Hard,7,16,23,151,30.43
2709,Hans Simonsson,Carpet,5,9,14,116,35.71
2710,Hans Simonsson,Clay,22,40,62,116,35.48
2711,Hans Simonsson,Grass,2,6,8,116,25.0
2712,Hans Simonsson,Hard,13,19,32,116,40.62
2713,Hansjorg Elzer,Clay,1,5,6,6,16.67
2714,Hao Lu,Hard,1,2,3,3,33.33
2715,Harald Elschenbroich,Carpet,1,7,8,193,12.5
2716,Harald Elschenbroich,Clay,78,72,150,193,52.0
2717,Harald Elschenbroich,Grass,6,11,17,193,35.29
2718,Harald Elschenbroich,Hard,9,9,18,193,50.0
2719,Harald Mair,Clay,1,1,2,2,50.0
2720,Harald Rittersbacher,Hard,2,5,7,7,28.57
2721,Harald Theissen,Carpet,1,2,3,16,33.33
2722,Harald Theissen,Grass,2,2,4,16,50.0
2723,Harald Theissen,Hard,4,5,9,16,44.44
2724,Harel Levy,Carpet,3,5,8,162,37.5
2725,Harel Levy,Clay,17,24,41,162,41.46
2726,Harel Levy,Grass,6,10,16,162,37.5
2727,Harel Levy,Hard,37,60,97,162,38.14
2728,Harold Solomon,Carpet,117,90,207,893,56.52
2729,Harold Solomon,Clay,270,121,391,893,69.05
2730,Harold Solomon,Grass,6,15,21,893,28.57
2731,Harold Solomon,Hard,178,96,274,893,64.96
2732,Haroon Ismail,Carpet,4,5,9,77,44.44
2733,Haroon Ismail,Clay,15,32,47,77,31.91
2734,Haroon Ismail,Hard,9,12,21,77,42.86
2735,Haroon Rahim,Carpet,53,50,103,282,51.46
2736,Haroon Rahim,Clay,16,31,47,282,34.04
2737,Haroon Rahim,Grass,9,18,27,282,33.33
2738,Haroon Rahim,Hard,50,55,105,282,47.62
2739,Harri Heliovaara,Clay,1,4,5,21,20.0
2740,Harri Heliovaara,Hard,6,10,16,21,37.5
2741,Harry Barniville,Grass,1,2,3,3,33.33
2742,Harry Bourchier,Hard,1,1,2,2,50.0
2743,Harry Brittain,Grass,1,2,3,3,33.33
2744,Harry Fauquier,Clay,2,5,7,7,28.57
2745,Harry Fritz,Clay,1,3,4,6,25.0
2746,Harry Fritz,Hard,1,1,2,6,50.0
2747,Harry Sheridan,Grass,2,4,6,6,33.33
2748,Harry Turnbull,Hard,1,1,2,2,50.0
2749,Harsh Mankad,Grass,3,1,4,14,75.0
2750,Harsh Mankad,Hard,3,7,10,14,30.0
2751,Harshana Godamanna,Clay,7,4,11,17,63.64
2752,Harshana Godamanna,Hard,5,1,6,17,83.33
2753,Hartmut Kirchhubel,Clay,3,1,4,4,75.0
2754,Haseeb Aslam,Clay,2,2,4,4,50.0
2755,Hassan El Arousy,Clay,4,1,5,5,80.0
2756,Haydn Lewis,Hard,3,7,10,10,30.0
2757,Hazem Naw,Hard,1,1,2,2,50.0
2758,Hazuan Hizan,Hard,1,4,5,5,20.0
2759,Heath Denman,Hard,1,5,6,6,16.67
2760,Hector Romani,Clay,2,7,9,9,22.22
2761,Hee Seok Chung,Hard,6,1,7,7,85.71
2762,Heiner Moraing,Clay,1,1,2,11,50.0
2763,Heiner Moraing,Grass,1,1,2,11,50.0
2764,Heiner Moraing,Hard,2,5,7,11,28.57
2765,Heinz Gildemeister,Clay,14,11,25,27,56.0
2766,Heinz Gildemeister,Hard,1,1,2,27,50.0
2767,Heinz Gunthardt,Carpet,43,51,94,437,45.74
2768,Heinz Gunthardt,Clay,112,82,194,437,57.73
2769,Heinz Gunthardt,Grass,10,12,22,437,45.45
2770,Heinz Gunthardt,Hard,71,56,127,437,55.91
2771,Helder Lopes,Carpet,1,1,2,4,50.0
2772,Helder Lopes,Clay,1,1,2,4,50.0
2773,Helge Koll Frafjord,Carpet,3,1,4,17,75.0
2774,Helge Koll Frafjord,Clay,1,6,7,17,14.29
2775,Helge Koll Frafjord,Hard,1,5,6,17,16.67
2776,Helmar Stiegler,Clay,1,6,7,7,14.29
2777,Hendri Susilo Pramono,Hard,1,1,2,2,50.0
2778,Hendrik Dreekmann,Carpet,14,20,34,217,41.18
2779,Hendrik Dreekmann,Clay,23,38,61,217,37.7
2780,Hendrik Dreekmann,Grass,11,19,30,217,36.67
2781,Hendrik Dreekmann,Hard,49,43,92,217,53.26
2782,Hendrik Jan Davids,Carpet,1,7,8,34,12.5
2783,Hendrik Jan Davids,Clay,1,8,9,34,11.11
2784,Hendrik Jan Davids,Grass,1,5,6,34,16.67
2785,Hendrik Jan Davids,Hard,4,7,11,34,36.36
2786,Henri Kontinen,Carpet,1,1,2,10,50.0
2787,Henri Kontinen,Grass,1,1,2,10,50.0
2788,Henri Kontinen,Hard,2,4,6,10,33.33
2789,Henri Laaksonen,Clay,17,24,41,91,41.46
2790,Henri Laaksonen,Hard,20,30,50,91,40.0
2791,Henri Leconte,Carpet,70,62,132,648,53.03
2792,Henri Leconte,Clay,160,108,268,648,59.7
2793,Henri Leconte,Grass,60,33,93,648,64.52
2794,Henri Leconte,Hard,88,67,155,648,56.77
2795,Henrik Drzymalski,Clay,3,5,8,8,37.5
2796,Henrik Holm,Carpet,18,26,44,207,40.91
2797,Henrik Holm,Clay,5,14,19,207,26.32
2798,Henrik Holm,Grass,22,16,38,207,57.89
2799,Henrik Holm,Hard,51,55,106,207,48.11
2800,Henrik Sundstrom,Carpet,5,11,16,262,31.25
2801,Henrik Sundstrom,Clay,133,64,197,262,67.51
2802,Henrik Sundstrom,Grass,5,12,17,262,29.41
2803,Henrik Sundstrom,Hard,11,21,32,262,34.38
2804,Henry Adjei Darko,Clay,1,1,2,6,50.0
2805,Henry Adjei Darko,Hard,2,2,4,6,50.0
2806,Henry Bunis,Carpet,4,8,12,87,33.33
2807,Henry Bunis,Clay,15,33,48,87,31.25
2808,Henry Bunis,Grass,4,8,12,87,33.33
2809,Henry Bunis,Hard,5,10,15,87,33.33
2810,Henry Estrella,Clay,3,2,5,5,60.0
2811,Henry Hank Irvine,Clay,4,6,10,36,40.0
2812,Henry Hank Irvine,Grass,3,7,10,36,30.0
2813,Henry Hank Irvine,Hard,6,10,16,36,37.5
2814,Henry Hank Kamakana,Carpet,1,1,2,2,50.0
2815,Herb Fitzgibbon,Carpet,1,3,4,49,25.0
2816,Herb Fitzgibbon,Clay,9,4,13,49,69.23
2817,Herb Fitzgibbon,Grass,10,11,21,49,47.62
2818,Herb Fitzgibbon,Hard,6,5,11,49,54.55
2819,Herbert Wiltschnig,Clay,3,12,15,18,20.0
2820,Herbert Wiltschnig,Hard,1,2,3,18,33.33
2821,Herkko Pollanen,Hard,1,1,2,2,50.0
2822,Hermes Gamonal,Clay,4,8,12,15,33.33
2823,Hermes Gamonal,Hard,1,2,3,15,33.33
2824,Hernan Gumy,Clay,89,85,174,240,51.15
2825,Hernan Gumy,Hard,26,40,66,240,39.39
2826,Herve Gauvain,Carpet,6,4,10,30,60.0
2827,Herve Gauvain,Clay,3,17,20,30,15.0
2828,Hervoje Eterovic,Clay,1,3,4,4,25.0
2829,Hicham Arazi,Carpet,29,29,58,447,50.0
2830,Hicham Arazi,Clay,92,92,184,447,50.0
2831,Hicham Arazi,Grass,18,17,35,447,51.43
2832,Hicham Arazi,Hard,82,88,170,447,48.24
2833,Hicham Khaddari,Clay,1,2,3,3,33.33
2834,Hideki Kaneko,Carpet,2,4,6,19,33.33
2835,Hideki Kaneko,Clay,1,1,2,19,50.0
2836,Hideki Kaneko,Hard,3,8,11,19,27.27
2837,Hira Lal Rahman,Clay,1,1,2,6,50.0
2838,Hira Lal Rahman,Hard,1,3,4,6,25.0
2839,Hiroki Kondo,Hard,1,3,4,4,25.0
2840,Hiroki Moriya,Hard,2,8,10,10,20.0
2841,Hisham Hemeda,Clay,3,1,4,4,75.0
2842,Hisham Nasser,Clay,4,5,9,11,44.44
2843,Hisham Nasser,Hard,1,1,2,11,50.0
2844,Hitoshi Shirato,Clay,1,2,3,12,33.33
2845,Hitoshi Shirato,Hard,3,6,9,12,33.33
2846,Hiu Tung Yu,Clay,2,3,5,28,40.0
2847,Hiu Tung Yu,Hard,10,13,23,28,43.48
2848,Holger Rune,Hard,4,1,5,5,80.0
2849,Hong Kit Jack Wong,Hard,1,1,2,2,50.0
2850,Horacio De La Pena,Carpet,2,6,8,364,25.0
2851,Horacio De La Pena,Clay,164,134,298,364,55.03
2852,Horacio De La Pena,Hard,24,34,58,364,41.38
2853,Horacio Zeballos,Clay,58,70,128,224,45.31
2854,Horacio Zeballos,Grass,2,11,13,224,15.38
2855,Horacio Zeballos,Hard,31,52,83,224,37.35
2856,Horst Skoff,Carpet,26,30,56,433,46.43
2857,Horst Skoff,Clay,179,124,303,433,59.08
2858,Horst Skoff,Grass,1,6,7,433,14.29
2859,Horst Skoff,Hard,23,44,67,433,34.33
2860,Houcine Saber,Clay,1,6,7,11,14.29
2861,Houcine Saber,Hard,1,3,4,11,25.0
2862,Howard Herr,Hard,2,4,6,6,33.33
2863,Howard Joffe,Hard,1,1,2,2,50.0
2864,Howard Sands,Grass,2,3,5,12,40.0
2865,Howard Sands,Hard,3,4,7,12,42.86
2866,Howard Schoenfield,Clay,3,21,24,42,12.5
2867,Howard Schoenfield,Hard,8,10,18,42,44.44
2868,Hsin Han Lee,Hard,1,1,2,2,50.0
2869,Huang Jung Hsu,Clay,1,1,2,18,50.0
2870,Huang Jung Hsu,Hard,5,11,16,18,31.25
2871,Hubert Hurkacz,Clay,8,12,20,110,40.0
2872,Hubert Hurkacz,Grass,4,4,8,110,50.0
2873,Hubert Hurkacz,Hard,42,40,82,110,51.22
2874,Hubertus Hoyt,Carpet,1,4,5,21,20.0
2875,Hubertus Hoyt,Clay,1,9,10,21,10.0
2876,Hubertus Hoyt,Hard,1,5,6,21,16.67
2877,Hugo Armando,Clay,11,27,38,43,28.95
2878,Hugo Armando,Hard,2,3,5,43,40.0
2879,Hugo Chapacu,Clay,6,9,15,15,40.0
2880,Hugo Dellien,Clay,17,20,37,52,45.95
2881,Hugo Dellien,Hard,5,10,15,52,33.33
2882,Hugo Gaston,Clay,3,1,4,4,75.0
2883,Hugo Grenier,Hard,1,1,2,2,50.0
2884,Hugo Nunez,Hard,2,6,8,8,25.0
2885,Hugo Roverano,Clay,5,4,9,9,55.56
2886,Hugo Varela,Clay,1,5,6,6,16.67
2887,Humphrey Hose,Carpet,1,3,4,56,25.0
2888,Humphrey Hose,Clay,7,18,25,56,28.0
2889,Humphrey Hose,Grass,4,8,12,56,33.33
2890,Humphrey Hose,Hard,6,9,15,56,40.0
2891,Hussain Akbari,Hard,2,2,4,4,50.0
2892,Hussain Al Ashwak,Hard,2,3,5,5,40.0
2893,Huub Van Boeckel,Carpet,2,5,7,62,28.57
2894,Huub Van Boeckel,Clay,6,13,19,62,31.58
2895,Huub Van Boeckel,Grass,9,12,21,62,42.86
2896,Huub Van Boeckel,Hard,4,11,15,62,26.67
2897,Hyeon Chung,Clay,17,14,31,147,54.84
2898,Hyeon Chung,Grass,1,2,3,147,33.33
2899,Hyeon Chung,Hard,60,53,113,147,53.1
2900,Hyun Woo Nam,Hard,1,2,3,3,33.33
2901,Hyung Taik Lee,Carpet,11,6,17,327,64.71
2902,Hyung Taik Lee,Clay,31,31,62,327,50.0
2903,Hyung Taik Lee,Grass,19,20,39,327,48.72
2904,Hyung Taik Lee,Hard,101,108,209,327,48.33
2905,Ian Crookenden,Carpet,3,10,13,30,23.08
2906,Ian Crookenden,Hard,5,12,17,30,29.41
2907,Ian Flanagan,Grass,2,1,3,3,66.67
2908,Ian Fletcher,Carpet,11,17,28,160,39.29
2909,Ian Fletcher,Clay,20,27,47,160,42.55
2910,Ian Fletcher,Grass,22,19,41,160,53.66
2911,Ian Fletcher,Hard,20,24,44,160,45.45
2912,Ian Harris,Hard,1,1,2,2,50.0
2913,Ian Hewitt,Clay,3,1,4,4,75.0
2914,Ibrahim Mahmoud,Clay,1,4,5,5,20.0
2915,Ifthekar Sardar,Hard,1,9,10,10,10.0
2916,Ignacio Garcia,Hard,1,4,5,5,20.0
2917,Ignacio Garcia Atance,Clay,1,1,2,2,50.0
2918,Ignacio Hirigoyen,Clay,1,2,3,3,33.33
2919,Ignacio Martinez,Hard,1,3,4,4,25.0
2920,Ignacio Truyol,Clay,3,4,7,10,42.86
2921,Ignacio Truyol,Hard,1,2,3,10,33.33
2922,Igor Andreev,Carpet,11,9,20,469,55.0
2923,Igor Andreev,Clay,118,103,221,469,53.39
2924,Igor Andreev,Grass,16,17,33,469,48.48
2925,Igor Andreev,Hard,93,102,195,469,47.69
2926,Igor Flego,Clay,1,1,2,2,50.0
2927,Igor Kornienko,Carpet,2,2,4,4,50.0
2928,Igor Kunitsyn,Carpet,11,10,21,242,52.38
2929,Igor Kunitsyn,Clay,8,22,30,242,26.67
2930,Igor Kunitsyn,Grass,12,25,37,242,32.43
2931,Igor Kunitsyn,Hard,58,96,154,242,37.66
2932,Igor Saric,Clay,2,2,4,4,50.0
2933,Igor Sijsling,Clay,10,23,33,138,30.3
2934,Igor Sijsling,Grass,10,13,23,138,43.48
2935,Igor Sijsling,Hard,29,53,82,138,35.37
2936,Igor Tihonenko,Clay,1,1,2,2,50.0
2937,Ilan Sher,Hard,1,2,3,3,33.33
2938,Ilia Kushev,Clay,2,5,7,7,28.57
2939,Ilie Nastase,Carpet,165,95,260,1153,63.46
2940,Ilie Nastase,Clay,394,109,503,1153,78.33
2941,Ilie Nastase,Grass,78,33,111,1153,70.27
2942,Ilie Nastase,Hard,196,83,279,1153,70.25
2943,Ilija Bozoljac,Carpet,3,2,5,30,60.0
2944,Ilija Bozoljac,Clay,3,3,6,30,50.0
2945,Ilija Bozoljac,Grass,3,6,9,30,33.33
2946,Ilija Bozoljac,Hard,2,8,10,30,20.0
2947,Ilija Martinoski,Clay,1,2,3,3,33.33
2948,Illya Marchenko,Clay,3,15,18,147,16.67
2949,Illya Marchenko,Grass,6,14,20,147,30.0
2950,Illya Marchenko,Hard,50,59,109,147,45.87
2951,Ilou Lonfo,Hard,4,4,8,8,50.0
2952,Ilya Ivashka,Clay,1,6,7,59,14.29
2953,Ilya Ivashka,Grass,2,1,3,59,66.67
2954,Ilya Ivashka,Hard,23,26,49,59,46.94
2955,Inaki Calvo,Hard,1,3,4,4,25.0
2956,Ingo Buding,Carpet,2,3,5,71,40.0
2957,Ingo Buding,Clay,26,20,46,71,56.52
2958,Ingo Buding,Grass,2,7,9,71,22.22
2959,Ingo Buding,Hard,4,7,11,71,36.36
2960,Ingo Wimmer,Hard,2,2,4,4,50.0
2961,Inigo Cervantes Huegun,Clay,12,20,32,49,37.5
2962,Inigo Cervantes Huegun,Grass,1,3,4,49,25.0
2963,Inigo Cervantes Huegun,Hard,4,9,13,49,30.77
2964,Ioannis Kabakoglou,Clay,1,2,3,3,33.33
2965,Ion Moldovan,Clay,4,11,15,15,26.67
2966,Ion Tiriac,Carpet,19,29,48,375,39.58
2967,Ion Tiriac,Clay,127,87,214,375,59.35
2968,Ion Tiriac,Grass,19,22,41,375,46.34
2969,Ion Tiriac,Hard,29,43,72,375,40.28
2970,Ionel Santeiu,Carpet,2,5,7,14,28.57
2971,Ionel Santeiu,Clay,2,5,7,14,28.57
2972,Iphton Louis,Hard,1,1,2,2,50.0
2973,Irakli Labadze,Carpet,3,4,7,134,42.86
2974,Irakli Labadze,Clay,27,33,60,134,45.0
2975,Irakli Labadze,Grass,5,9,14,134,35.71
2976,Irakli Labadze,Hard,16,37,53,134,30.19
2977,Irakli Ushangishvili,Clay,1,1,2,2,50.0
2978,Isaac Donkor,Hard,5,5,10,10,50.0
2979,Isak Arvidsson,Hard,1,7,8,8,12.5
2980,Isao Watanabe,Clay,1,4,5,5,20.0
2981,Islam Ul Haq,Clay,4,3,7,7,57.14
2982,Ismail El Shafei,Carpet,25,53,78,477,32.05
2983,Ismail El Shafei,Clay,101,111,212,477,47.64
2984,Ismail El Shafei,Grass,38,37,75,477,50.67
2985,Ismail El Shafei,Hard,52,60,112,477,46.43
2986,Ismar Gorcic,Clay,1,2,3,3,33.33
2987,Israel Morales,Hard,2,2,4,4,50.0
2988,Issam Al Tawil,Clay,1,1,2,7,50.0
2989,Issam Al Tawil,Hard,1,4,5,7,20.0
2990,Istvan Gulyas,Clay,43,36,79,86,54.43
2991,Istvan Gulyas,Hard,4,3,7,86,57.14
2992,Ivan Baron,Clay,1,5,6,6,16.67
2993,Ivan Beros,Clay,1,1,2,2,50.0
2994,Ivan Dodig,Clay,27,37,64,258,42.19
2995,Ivan Dodig,Grass,17,14,31,258,54.84
2996,Ivan Dodig,Hard,74,89,163,258,45.4
2997,Ivan Du Pasquier,Clay,2,1,3,3,66.67
2998,Ivan Dupasquier,Carpet,3,4,7,35,42.86
2999,Ivan Dupasquier,Clay,12,16,28,35,42.86
3000,Ivan Endara,Clay,4,7,11,15,36.36
3001,Ivan Endara,Hard,1,3,4,15,25.0
3002,Ivan Keskinov,Clay,8,7,15,15,53.33
3003,Ivan Kley,Carpet,1,3,4,52,25.0
3004,Ivan Kley,Clay,4,24,28,52,14.29
3005,Ivan Kley,Hard,9,11,20,52,45.0
3006,Ivan Lendl,Carpet,271,55,326,1318,83.13
3007,Ivan Lendl,Clay,329,77,406,1318,81.03
3008,Ivan Lendl,Grass,81,27,108,1318,75.0
3009,Ivan Lendl,Hard,395,83,478,1318,82.64
3010,Ivan Ljubicic,Carpet,53,26,79,728,67.09
3011,Ivan Ljubicic,Clay,105,83,188,728,55.85
3012,Ivan Ljubicic,Grass,24,26,50,728,48.0
3013,Ivan Ljubicic,Hard,248,163,411,728,60.34
3014,Ivan Miranda,Carpet,1,2,3,59,33.33
3015,Ivan Miranda,Clay,16,17,33,59,48.48
3016,Ivan Miranda,Grass,2,1,3,59,66.67
3017,Ivan Miranda,Hard,6,14,20,59,30.0
3018,Ivan Molina,Carpet,8,12,20,329,40.0
3019,Ivan Molina,Clay,130,135,265,329,49.06
3020,Ivan Molina,Grass,2,12,14,329,14.29
3021,Ivan Molina,Hard,8,22,30,329,26.67
3022,Ivan Navarro,Clay,24,34,58,100,41.38
3023,Ivan Navarro,Grass,6,11,17,100,35.29
3024,Ivan Navarro,Hard,5,20,25,100,20.0
3025,Ivan Sergeyev,Hard,5,1,6,6,83.33
3026,Ivaylo Traykov,Carpet,4,3,7,18,57.14
3027,Ivaylo Traykov,Clay,5,6,11,18,45.45
3028,Ivo Heuberger,Carpet,7,12,19,113,36.84
3029,Ivo Heuberger,Clay,2,14,16,113,12.5
3030,Ivo Heuberger,Grass,4,8,12,113,33.33
3031,Ivo Heuberger,Hard,21,45,66,113,31.82
3032,Ivo Karlovic,Carpet,8,9,17,715,47.06
3033,Ivo Karlovic,Clay,56,76,132,715,42.42
3034,Ivo Karlovic,Grass,73,43,116,715,62.93
3035,Ivo Karlovic,Hard,235,215,450,715,52.22
3036,Ivo Klec,Clay,1,3,4,9,25.0
3037,Ivo Klec,Hard,1,4,5,9,20.0
3038,Ivo Minar,Clay,14,30,44,101,31.82
3039,Ivo Minar,Grass,3,10,13,101,23.08
3040,Ivo Minar,Hard,18,26,44,101,40.91
3041,Ivo Werner,Carpet,2,1,3,10,66.67
3042,Ivo Werner,Hard,3,4,7,10,42.86
3043,Izak Van Der Merwe,Clay,1,2,3,30,33.33
3044,Izak Van Der Merwe,Grass,2,2,4,30,50.0
3045,Izak Van Der Merwe,Hard,13,10,23,30,56.52
3046,Iztok Bozic,Carpet,1,3,4,28,25.0
3047,Iztok Bozic,Clay,10,8,18,28,55.56
3048,Iztok Bozic,Hard,3,3,6,28,50.0
3049,J Bougher,Grass,1,1,2,2,50.0
3050,J.J. Wolf,Hard,2,3,5,5,40.0
3051,Jaak Poldma,Hard,3,4,7,7,42.86
3052,Jacco Eltingh,Carpet,27,28,55,274,49.09
3053,Jacco Eltingh,Clay,36,38,74,274,48.65
3054,Jacco Eltingh,Grass,27,20,47,274,57.45
3055,Jacco Eltingh,Hard,37,61,98,274,37.76
3056,Jacek Niedzwiedzki,Carpet,2,4,6,19,33.33
3057,Jacek Niedzwiedzki,Clay,4,2,6,19,66.67
3058,Jacek Niedzwiedzki,Hard,5,2,7,19,71.43
3059,Jack Brasington,Clay,1,2,3,9,33.33
3060,Jack Brasington,Hard,1,5,6,9,16.67
3061,Jack Sock,Clay,33,24,57,298,57.89
3062,Jack Sock,Grass,12,11,23,298,52.17
3063,Jack Sock,Hard,121,97,218,298,55.5
3064,Jack Waltz,Grass,1,1,2,2,50.0
3065,Jackie Saul,Grass,1,1,2,17,50.0
3066,Jackie Saul,Hard,8,7,15,17,53.33
3067,Jacobo Chavez,Hard,6,9,15,15,40.0
3068,Jacobo Diaz,Clay,25,42,67,88,37.31
3069,Jacobo Diaz,Hard,3,18,21,88,14.29
3070,Jacques Manset,Hard,1,2,3,3,33.33
3071,Jacques Radoux,Carpet,2,1,3,11,66.67
3072,Jacques Radoux,Clay,1,1,2,11,50.0
3073,Jacques Radoux,Hard,4,2,6,11,66.67
3074,Jacques Thamin,Clay,6,12,18,23,33.33
3075,Jacques Thamin,Grass,2,3,5,23,40.0
3076,Jae Sik Kim,Clay,4,2,6,6,66.67
3077,Jai Dilouie,Clay,2,5,7,18,28.57
3078,Jai Dilouie,Grass,1,3,4,18,25.0
3079,Jai Dilouie,Hard,1,6,7,18,14.29
3080,Jaidip Mukerjea,Clay,3,7,10,25,30.0
3081,Jaidip Mukerjea,Grass,7,8,15,25,46.67
3082,Jaidip Mukherjea,Grass,11,10,21,21,52.38
3083,Jaime Cortes,Clay,4,7,11,11,36.36
3084,Jaime Fillol,Carpet,54,52,106,809,50.94
3085,Jaime Fillol,Clay,259,148,407,809,63.64
3086,Jaime Fillol,Grass,43,39,82,809,52.44
3087,Jaime Fillol,Hard,120,94,214,809,56.07
3088,Jaime Oncins,Carpet,3,7,10,171,30.0
3089,Jaime Oncins,Clay,38,42,80,171,47.5
3090,Jaime Oncins,Grass,2,2,4,171,50.0
3091,Jaime Oncins,Hard,33,44,77,171,42.86
3092,Jaime Pinto Bravo,Carpet,2,8,10,189,20.0
3093,Jaime Pinto Bravo,Clay,62,78,140,189,44.29
3094,Jaime Pinto Bravo,Grass,3,12,15,189,20.0
3095,Jaime Pinto Bravo,Hard,8,16,24,189,33.33
3096,Jaime Yzaga,Carpet,19,21,40,491,47.5
3097,Jaime Yzaga,Clay,101,86,187,491,54.01
3098,Jaime Yzaga,Grass,5,7,12,491,41.67
3099,Jaime Yzaga,Hard,142,110,252,491,56.35
3100,Jairo Velasco,Carpet,1,7,8,282,12.5
3101,Jairo Velasco,Clay,119,143,262,282,45.42
3102,Jairo Velasco,Hard,2,10,12,282,16.67
3103,Jairo Velasco Jr,Clay,1,1,2,2,50.0
3104,Jakob Hlasek,Carpet,142,90,232,773,61.21
3105,Jakob Hlasek,Clay,106,85,191,773,55.5
3106,Jakob Hlasek,Grass,36,34,70,773,51.43
3107,Jakob Hlasek,Hard,156,124,280,773,55.71
3108,Jalil Khan,Clay,1,1,2,7,50.0
3109,Jalil Khan,Hard,1,4,5,7,20.0
3110,James Auckland,Hard,2,1,3,3,66.67
3111,James Blake,Carpet,7,9,16,626,43.75
3112,James Blake,Clay,46,54,100,626,46.0
3113,James Blake,Grass,32,30,62,626,51.61
3114,James Blake,Hard,283,165,448,626,63.17
3115,James Buckley,Grass,2,5,7,7,28.57
3116,James Chico Hagey,Carpet,4,9,13,66,30.77
3117,James Chico Hagey,Clay,3,16,19,66,15.79
3118,James Chico Hagey,Grass,2,11,13,66,15.38
3119,James Chico Hagey,Hard,9,12,21,66,42.86
3120,James Duckworth,Clay,2,6,8,85,25.0
3121,James Duckworth,Grass,2,7,9,85,22.22
3122,James Duckworth,Hard,24,44,68,85,35.29
3123,James Greenhalgh,Hard,1,11,12,12,8.33
3124,James Mcgee,Carpet,3,2,5,19,60.0
3125,James Mcgee,Clay,2,1,3,19,66.67
3126,James Mcgee,Hard,4,7,11,19,36.36
3127,James Sekulov,Hard,6,11,17,17,35.29
3128,James Shortall,Hard,1,2,3,3,33.33
3129,James Turner,Grass,2,7,9,9,22.22
3130,James Ward,Grass,13,31,44,77,29.55
3131,James Ward,Hard,11,22,33,77,33.33
3132,Jamie Baker,Clay,1,2,3,27,33.33
3133,Jamie Baker,Grass,5,15,20,27,25.0
3134,Jamie Baker,Hard,1,3,4,27,25.0
3135,Jamie Delgado,Grass,7,18,25,40,28.0
3136,Jamie Delgado,Hard,4,11,15,40,26.67
3137,Jamie Morgan,Carpet,7,10,17,142,41.18
3138,Jamie Morgan,Clay,7,12,19,142,36.84
3139,Jamie Morgan,Grass,10,11,21,142,47.62
3140,Jamie Morgan,Hard,37,48,85,142,43.53
3141,Jamie Presslie,Grass,2,1,3,3,66.67
3142,Jan Apell,Carpet,6,11,17,112,35.29
3143,Jan Apell,Clay,10,19,29,112,34.48
3144,Jan Apell,Grass,6,5,11,112,54.55
3145,Jan Apell,Hard,22,33,55,112,40.0
3146,Jan Eric Lundquist,Carpet,1,1,2,25,50.0
3147,Jan Eric Lundquist,Clay,7,12,19,25,36.84
3148,Jan Eric Lundquist,Hard,1,3,4,25,25.0
3149,Jan Frode Andersen,Carpet,4,2,6,49,66.67
3150,Jan Frode Andersen,Clay,20,13,33,49,60.61
3151,Jan Frode Andersen,Hard,3,7,10,49,30.0
3152,Jan Gunnarsson,Carpet,22,39,61,393,36.07
3153,Jan Gunnarsson,Clay,92,98,190,393,48.42
3154,Jan Gunnarsson,Grass,9,10,19,393,47.37
3155,Jan Gunnarsson,Hard,67,56,123,393,54.47
3156,Jan Hajek,Clay,28,33,61,109,45.9
3157,Jan Hajek,Hard,8,40,48,109,16.67
3158,Jan Hernych,Carpet,4,9,13,197,30.77
3159,Jan Hernych,Clay,13,29,42,197,30.95
3160,Jan Hernych,Grass,19,21,40,197,47.5
3161,Jan Hernych,Hard,43,59,102,197,42.16
3162,Jan Hordijk,Clay,9,9,18,25,50.0
3163,Jan Hordijk,Hard,4,3,7,25,57.14
3164,Jan Kodes,Carpet,63,55,118,715,53.39
3165,Jan Kodes,Clay,295,131,426,715,69.25
3166,Jan Kodes,Grass,40,22,62,715,64.52
3167,Jan Kodes,Hard,57,52,109,715,52.29
3168,Jan Kodes Jr,Clay,1,3,4,4,25.0
3169,Jan Kroslak,Carpet,25,24,49,172,51.02
3170,Jan Kroslak,Clay,10,20,30,172,33.33
3171,Jan Kroslak,Grass,4,9,13,172,30.77
3172,Jan Kroslak,Hard,37,43,80,172,46.25
3173,Jan Kukal,Carpet,3,3,6,106,50.0
3174,Jan Kukal,Clay,25,37,62,106,40.32
3175,Jan Kukal,Grass,8,12,20,106,40.0
3176,Jan Kukal,Hard,5,13,18,106,27.78
3177,Jan Lennard Struff,Clay,43,52,95,307,45.26
3178,Jan Lennard Struff,Grass,12,20,32,307,37.5
3179,Jan Lennard Struff,Hard,87,93,180,307,48.33
3180,Jan Leschly,Carpet,2,1,3,67,66.67
3181,Jan Leschly,Clay,13,12,25,67,52.0
3182,Jan Leschly,Grass,8,6,14,67,57.14
3183,Jan Leschly,Hard,15,10,25,67,60.0
3184,Jan Mertl,Clay,1,1,2,2,50.0
3185,Jan Michael Gambill,Carpet,8,12,20,401,40.0
3186,Jan Michael Gambill,Clay,10,37,47,401,21.28
3187,Jan Michael Gambill,Grass,23,21,44,401,52.27
3188,Jan Michael Gambill,Hard,162,128,290,401,55.86
3189,Jan Norback,Carpet,7,15,22,115,31.82
3190,Jan Norback,Clay,12,34,46,115,26.09
3191,Jan Norback,Grass,3,6,9,115,33.33
3192,Jan Norback,Hard,15,23,38,115,39.47
3193,Jan Pisecky,Carpet,9,8,17,33,52.94
3194,Jan Pisecky,Clay,5,6,11,33,45.45
3195,Jan Pisecky,Hard,2,3,5,33,40.0
3196,Jan Satral,Hard,1,3,4,4,25.0
3197,Jan Siemerink,Carpet,83,62,145,547,57.24
3198,Jan Siemerink,Clay,33,54,87,547,37.93
3199,Jan Siemerink,Grass,28,32,60,547,46.67
3200,Jan Siemerink,Hard,131,124,255,547,51.37
3201,Jan Simbera,Carpet,2,2,4,14,50.0
3202,Jan Simbera,Clay,2,5,7,14,28.57
3203,Jan Simbera,Grass,1,2,3,14,33.33
3204,Jan Vacek,Clay,4,11,15,89,26.67
3205,Jan Vacek,Grass,14,15,29,89,48.28
3206,Jan Vacek,Hard,12,33,45,89,26.67
3207,Jan Van Langendonck,Clay,7,7,14,19,50.0
3208,Jan Van Langendonck,Hard,2,3,5,19,40.0
3209,Jan Willem Lodder,Clay,2,2,4,4,50.0
3210,Jan Zabrodsky,Carpet,1,3,4,4,25.0
3211,Janko Tipsarevic,Carpet,5,8,13,550,38.46
3212,Janko Tipsarevic,Clay,73,69,142,550,51.41
3213,Janko Tipsarevic,Grass,38,34,72,550,52.78
3214,Janko Tipsarevic,Hard,173,150,323,550,53.56
3215,Jannik Sinner,Clay,10,7,17,53,58.82
3216,Jannik Sinner,Hard,22,14,36,53,61.11
3217,Janos Benyik,Clay,7,16,23,28,30.43
3218,Janos Benyik,Hard,2,3,5,28,40.0
3219,Janos Guti,Carpet,1,1,2,2,50.0
3220,Jared Donaldson,Clay,4,11,15,110,26.67
3221,Jared Donaldson,Grass,6,8,14,110,42.86
3222,Jared Donaldson,Hard,38,43,81,110,46.91
3223,Jared Palmer,Carpet,6,8,14,150,42.86
3224,Jared Palmer,Clay,20,18,38,150,52.63
3225,Jared Palmer,Grass,7,11,18,150,38.89
3226,Jared Palmer,Hard,37,43,80,150,46.25
3227,Jarkko Nieminen,Carpet,20,14,34,759,58.82
3228,Jarkko Nieminen,Clay,115,90,205,759,56.1
3229,Jarkko Nieminen,Grass,25,32,57,759,43.86
3230,Jarkko Nieminen,Hard,249,214,463,759,53.78
3231,Jaromir Becka,Carpet,1,3,4,31,25.0
3232,Jaromir Becka,Clay,4,6,10,31,40.0
3233,Jaromir Becka,Hard,8,9,17,31,47.06
3234,Jaroslav Bulant,Clay,2,8,10,10,20.0
3235,Jaroslav Navratil,Carpet,1,5,6,90,16.67
3236,Jaroslav Navratil,Clay,22,37,59,90,37.29
3237,Jaroslav Navratil,Hard,9,16,25,90,36.0
3238,Jaroslav Pospisil,Hard,1,2,3,3,33.33
3239,Jasjit Singh,Clay,9,18,27,57,33.33
3240,Jasjit Singh,Grass,4,13,17,57,23.53
3241,Jasjit Singh,Hard,4,9,13,57,30.77
3242,Jason Cask,Hard,1,2,3,3,33.33
3243,Jason Jung,Grass,2,4,6,25,33.33
3244,Jason Jung,Hard,6,13,19,25,31.58
3245,Jason Kubler,Clay,1,1,2,10,50.0
3246,Jason Kubler,Hard,2,6,8,10,25.0
3247,Jason Stoltenberg,Carpet,13,26,39,572,33.33
3248,Jason Stoltenberg,Clay,59,43,102,572,57.84
3249,Jason Stoltenberg,Grass,59,37,96,572,61.46
3250,Jason Stoltenberg,Hard,174,161,335,572,51.94
3251,Jaume Munar,Clay,23,26,49,76,46.94
3252,Jaume Munar,Hard,8,19,27,76,29.63
3253,Javier Frana,Carpet,8,15,23,324,34.78
3254,Javier Frana,Clay,66,49,115,324,57.39
3255,Javier Frana,Grass,40,32,72,324,55.56
3256,Javier Frana,Hard,51,63,114,324,44.74
3257,Javier Marti,Clay,1,8,9,11,11.11
3258,Javier Marti,Grass,1,1,2,11,50.0
3259,Javier Molina,Clay,1,1,2,2,50.0
3260,Javier Ordaz,Clay,1,3,4,4,25.0
3261,Javier Restrepo,Carpet,1,2,3,16,33.33
3262,Javier Restrepo,Clay,2,11,13,16,15.38
3263,Javier Sanchez,Carpet,19,33,52,661,36.54
3264,Javier Sanchez,Clay,215,185,400,661,53.75
3265,Javier Sanchez,Grass,3,8,11,661,27.27
3266,Javier Sanchez,Hard,90,108,198,661,45.45
3267,Javier Soler,Clay,28,46,74,74,37.84
3268,Jay Berger,Carpet,9,9,18,223,50.0
3269,Jay Berger,Clay,51,28,79,223,64.56
3270,Jay Berger,Grass,1,1,2,223,50.0
3271,Jay Berger,Hard,82,42,124,223,66.13
3272,Jay Clarke,Grass,2,6,8,8,25.0
3273,Jay Lapidus,Carpet,7,13,20,182,35.0
3274,Jay Lapidus,Clay,17,26,43,182,39.53
3275,Jay Lapidus,Grass,16,22,38,182,42.11
3276,Jay Lapidus,Hard,36,45,81,182,44.44
3277,Jay Royappa,Carpet,1,1,2,10,50.0
3278,Jay Royappa,Clay,1,2,3,10,33.33
3279,Jay Royappa,Grass,1,4,5,10,20.0
3280,Jayendra Wijeyesekera,Clay,6,9,15,24,40.0
3281,Jayendra Wijeyesekera,Hard,2,7,9,24,22.22
3282,Jaymon Crabb,Hard,1,8,9,9,11.11
3283,Jean Baptiste Chanfreau,Carpet,7,19,26,162,26.92
3284,Jean Baptiste Chanfreau,Clay,15,51,66,162,22.73
3285,Jean Baptiste Chanfreau,Grass,17,22,39,162,43.59
3286,Jean Baptiste Chanfreau,Hard,11,20,31,162,35.48
3287,Jean Baptiste Perlant,Clay,1,2,3,6,33.33
3288,Jean Baptiste Perlant,Hard,1,2,3,6,33.33
3289,Jean Christophe Faurel,Hard,2,4,6,6,33.33
3290,Jean Claude Barclay,Clay,13,26,39,54,33.33
3291,Jean Claude Barclay,Grass,1,7,8,54,12.5
3292,Jean Claude Barclay,Hard,3,4,7,54,42.86
3293,Jean Claude Scherrer,Hard,1,2,3,3,33.33
3294,Jean Courcol,Clay,8,8,16,20,50.0
3295,Jean Courcol,Grass,1,3,4,20,25.0
3296,Jean Francois Bachelot,Carpet,2,2,4,9,50.0
3297,Jean Francois Bachelot,Clay,1,2,3,9,33.33
3298,Jean Francois Bachelot,Hard,1,1,2,9,50.0
3299,Jean Francois Caujolle,Carpet,7,8,15,192,46.67
3300,Jean Francois Caujolle,Clay,66,81,147,192,44.9
3301,Jean Francois Caujolle,Grass,2,13,15,192,13.33
3302,Jean Francois Caujolle,Hard,5,10,15,192,33.33
3303,Jean Jacques Kouassi,Clay,1,1,2,2,50.0
3304,Jean Louis Haillet,Carpet,4,8,12,137,33.33
3305,Jean Louis Haillet,Clay,25,55,80,137,31.25
3306,Jean Louis Haillet,Grass,3,7,10,137,30.0
3307,Jean Louis Haillet,Hard,16,19,35,137,45.71
3308,Jean Loup Rouyer,Clay,40,34,74,113,54.05
3309,Jean Loup Rouyer,Grass,12,19,31,113,38.71
3310,Jean Loup Rouyer,Hard,3,5,8,113,37.5
3311,Jean Lovera,Clay,1,4,5,5,20.0
3312,Jean Marc Piacentile,Carpet,1,1,2,2,50.0
3313,Jean Michel Durango,Clay,1,1,2,2,50.0
3314,Jean Nabi,Carpet,2,1,3,18,66.67
3315,Jean Nabi,Clay,1,6,7,18,14.29
3316,Jean Nabi,Hard,1,7,8,18,12.5
3317,Jean Paul Meyer,Clay,4,11,15,25,26.67
3318,Jean Paul Meyer,Grass,3,7,10,25,30.0
3319,Jean Philippe Fleurian,Carpet,14,18,32,263,43.75
3320,Jean Philippe Fleurian,Clay,28,44,72,263,38.89
3321,Jean Philippe Fleurian,Grass,6,9,15,263,40.0
3322,Jean Philippe Fleurian,Hard,59,85,144,263,40.97
3323,Jean Pierre Courcol,Clay,3,3,6,12,50.0
3324,Jean Pierre Courcol,Grass,4,2,6,12,66.67
3325,Jean Pierre Loizeau,Clay,1,5,6,6,16.67
3326,Jean Rene Lisnard,Carpet,2,3,5,140,40.0
3327,Jean Rene Lisnard,Clay,29,42,71,140,40.85
3328,Jean Rene Lisnard,Grass,1,4,5,140,20.0
3329,Jean Rene Lisnard,Hard,21,38,59,140,35.59
3330,Jean Yves Job,Hard,3,1,4,4,75.0
3331,Jeff Austin,Carpet,15,19,34,115,44.12
3332,Jeff Austin,Clay,5,14,19,115,26.32
3333,Jeff Austin,Grass,8,14,22,115,36.36
3334,Jeff Austin,Hard,17,23,40,115,42.5
3335,Jeff Borowiak,Carpet,64,74,138,554,46.38
3336,Jeff Borowiak,Clay,94,85,179,554,52.51
3337,Jeff Borowiak,Grass,30,37,67,554,44.78
3338,Jeff Borowiak,Hard,78,92,170,554,45.88
3339,Jeff Davis,Hard,1,1,2,2,50.0
3340,Jeff Klaparda,Hard,5,8,13,13,38.46
3341,Jeff Morrison,Clay,1,6,7,90,14.29
3342,Jeff Morrison,Grass,6,10,16,90,37.5
3343,Jeff Morrison,Hard,25,42,67,90,37.31
3344,Jeff Robinson,Clay,1,1,2,2,50.0
3345,Jeff Salzenstein,Clay,1,3,4,57,25.0
3346,Jeff Salzenstein,Grass,3,6,9,57,33.33
3347,Jeff Salzenstein,Hard,12,32,44,57,27.27
3348,Jeff Simpson,Carpet,6,9,15,114,40.0
3349,Jeff Simpson,Clay,9,25,34,114,26.47
3350,Jeff Simpson,Grass,17,17,34,114,50.0
3351,Jeff Simpson,Hard,7,24,31,114,22.58
3352,Jeff Tarango,Carpet,31,41,72,534,43.06
3353,Jeff Tarango,Clay,49,59,108,534,45.37
3354,Jeff Tarango,Grass,14,27,41,534,34.15
3355,Jeff Tarango,Hard,146,167,313,534,46.65
3356,Jeff Turpin,Clay,3,2,5,19,60.0
3357,Jeff Turpin,Grass,3,6,9,19,33.33
3358,Jeff Turpin,Hard,2,3,5,19,40.0
3359,Jeff Twist,Hard,2,2,4,4,50.0
3360,Jens Knippschild,Carpet,3,5,8,117,37.5
3361,Jens Knippschild,Clay,23,35,58,117,39.66
3362,Jens Knippschild,Grass,12,10,22,117,54.55
3363,Jens Knippschild,Hard,10,19,29,117,34.48
3364,Jens Peter,Clay,1,1,2,2,50.0
3365,Jens Woehrmann,Carpet,6,7,13,48,46.15
3366,Jens Woehrmann,Clay,11,15,26,48,42.31
3367,Jens Woehrmann,Grass,1,2,3,48,33.33
3368,Jens Woehrmann,Hard,2,4,6,48,33.33
3369,Jenson Brooksby,Hard,1,2,3,3,33.33
3370,Jeremy Bates,Carpet,19,32,51,322,37.25
3371,Jeremy Bates,Clay,10,29,39,322,25.64
3372,Jeremy Bates,Grass,43,51,94,322,45.74
3373,Jeremy Bates,Hard,58,80,138,322,42.03
3374,Jeremy Chardy,Clay,103,94,197,574,52.28
3375,Jeremy Chardy,Grass,28,30,58,574,48.28
3376,Jeremy Chardy,Hard,155,164,319,574,48.59
3377,Jeremy Cohen,Grass,1,2,3,7,33.33
3378,Jeremy Cohen,Hard,1,3,4,7,25.0
3379,Jerome Golmard,Carpet,11,15,26,289,42.31
3380,Jerome Golmard,Clay,34,42,76,289,44.74
3381,Jerome Golmard,Grass,15,17,32,289,46.88
3382,Jerome Golmard,Hard,85,70,155,289,54.84
3383,Jerome Haehnel,Carpet,1,1,2,23,50.0
3384,Jerome Haehnel,Clay,1,9,10,23,10.0
3385,Jerome Haehnel,Hard,6,5,11,23,54.55
3386,Jerome Potier,Carpet,5,15,20,146,25.0
3387,Jerome Potier,Clay,26,46,72,146,36.11
3388,Jerome Potier,Grass,2,7,9,146,22.22
3389,Jerome Potier,Hard,21,24,45,146,46.67
3390,Jerome Seguin,Clay,8,7,15,15,53.33
3391,Jerome Vanier,Clay,3,10,13,20,23.08
3392,Jerome Vanier,Hard,2,5,7,20,28.57
3393,Jerry Joseph,Hard,1,1,2,2,50.0
3394,Jerry Van Linge,Carpet,1,2,3,3,33.33
3395,Jerzy Janowicz,Carpet,5,1,6,196,83.33
3396,Jerzy Janowicz,Clay,14,25,39,196,35.9
3397,Jerzy Janowicz,Grass,16,10,26,196,61.54
3398,Jerzy Janowicz,Hard,65,60,125,196,52.0
3399,Jeson Patrombon,Clay,4,4,8,16,50.0
3400,Jeson Patrombon,Hard,2,6,8,16,25.0
3401,Jesse Huta Galung,Clay,3,9,12,41,25.0
3402,Jesse Huta Galung,Grass,2,6,8,41,25.0
3403,Jesse Huta Galung,Hard,4,17,21,41,19.05
3404,Jesse Levine,Clay,1,6,7,95,14.29
3405,Jesse Levine,Grass,10,14,24,95,41.67
3406,Jesse Levine,Hard,20,44,64,95,31.25
3407,Jesse Witten,Hard,2,6,8,8,25.0
3408,Jesus Colas,Clay,2,8,10,10,20.0
3409,Jesus Francisco Felix,Clay,2,1,3,3,66.67
3410,Jhonnatan Medina Alvarez,Clay,2,2,4,19,50.0
3411,Jhonnatan Medina Alvarez,Hard,6,9,15,19,40.0
3412,Jhonson Garcia,Clay,10,5,15,30,66.67
3413,Jhonson Garcia,Hard,7,8,15,30,46.67
3414,Ji Sung Nam,Hard,2,3,5,5,40.0
3415,Jia Ping Xia,Clay,7,1,8,30,87.5
3416,Jia Ping Xia,Grass,2,2,4,30,50.0
3417,Jia Ping Xia,Hard,11,7,18,30,61.11
3418,Jicham Zaatini,Clay,1,3,4,20,25.0
3419,Jicham Zaatini,Hard,9,7,16,20,56.25
3420,Jim Corn,Clay,1,1,2,2,50.0
3421,Jim Courier,Carpet,72,47,119,745,60.5
3422,Jim Courier,Clay,115,53,168,745,68.45
3423,Jim Courier,Grass,28,17,45,745,62.22
3424,Jim Courier,Hard,293,120,413,745,70.94
3425,Jim Delaney,Carpet,16,25,41,207,39.02
3426,Jim Delaney,Clay,22,45,67,207,32.84
3427,Jim Delaney,Grass,16,21,37,207,43.24
3428,Jim Delaney,Hard,23,39,62,207,37.1
3429,Jim Grabb,Carpet,40,41,81,378,49.38
3430,Jim Grabb,Clay,3,13,16,378,18.75
3431,Jim Grabb,Grass,10,20,30,378,33.33
3432,Jim Grabb,Hard,126,125,251,378,50.2
3433,Jim Gurfein,Carpet,5,5,10,103,50.0
3434,Jim Gurfein,Clay,21,27,48,103,43.75
3435,Jim Gurfein,Grass,4,6,10,103,40.0
3436,Jim Gurfein,Hard,9,26,35,103,25.71
3437,Jim Mcmanus,Carpet,11,34,45,253,24.44
3438,Jim Mcmanus,Clay,19,62,81,253,23.46
3439,Jim Mcmanus,Grass,18,27,45,253,40.0
3440,Jim Mcmanus,Hard,30,52,82,253,36.59
3441,Jim Moore,Grass,4,2,6,6,66.67
3442,Jim Osborne,Carpet,5,8,13,134,38.46
3443,Jim Osborne,Clay,14,17,31,134,45.16
3444,Jim Osborne,Grass,14,15,29,134,48.28
3445,Jim Osborne,Hard,29,32,61,134,47.54
3446,Jim Pugh,Carpet,15,14,29,180,51.72
3447,Jim Pugh,Clay,12,19,31,180,38.71
3448,Jim Pugh,Grass,10,8,18,180,55.56
3449,Jim Pugh,Hard,48,54,102,180,47.06
3450,Jim Ward,Grass,1,2,3,8,33.33
3451,Jim Ward,Hard,1,4,5,8,20.0
3452,Jimmy Arias,Carpet,16,26,42,511,38.1
3453,Jimmy Arias,Clay,146,93,239,511,61.09
3454,Jimmy Arias,Grass,3,3,6,511,50.0
3455,Jimmy Arias,Hard,123,101,224,511,54.91
3456,Jimmy Brown,Carpet,4,12,16,312,25.0
3457,Jimmy Brown,Clay,92,95,187,312,49.2
3458,Jimmy Brown,Hard,43,66,109,312,39.45
3459,Jimmy Connors,Carpet,350,79,429,1533,81.59
3460,Jimmy Connors,Clay,208,62,270,1533,77.04
3461,Jimmy Connors,Grass,174,38,212,1533,82.08
3462,Jimmy Connors,Hard,510,112,622,1533,81.99
3463,Jimmy Taker,Clay,1,2,3,3,33.33
3464,Jimmy Wang,Clay,2,5,7,84,28.57
3465,Jimmy Wang,Grass,9,14,23,84,39.13
3466,Jimmy Wang,Hard,25,29,54,84,46.3
3467,Jimy Szymanski,Clay,10,14,24,53,41.67
3468,Jimy Szymanski,Hard,11,18,29,53,37.93
3469,Jin Sun Yoo,Clay,3,2,5,15,60.0
3470,Jin Sun Yoo,Hard,5,5,10,15,50.0
3471,Jin Yen Chiang,Clay,1,2,3,3,33.33
3472,Jing Zhu Yang,Hard,1,1,2,2,50.0
3473,Jirat Navasirisomboon,Clay,1,3,4,4,25.0
3474,Jiri Granat,Carpet,11,13,24,100,45.83
3475,Jiri Granat,Clay,18,28,46,100,39.13
3476,Jiri Granat,Hard,9,21,30,100,30.0
3477,Jiri Hrebec,Carpet,28,32,60,360,46.67
3478,Jiri Hrebec,Clay,119,102,221,360,53.85
3479,Jiri Hrebec,Grass,10,13,23,360,43.48
3480,Jiri Hrebec,Hard,23,33,56,360,41.07
3481,Jiri Novak,Carpet,38,32,70,604,54.29
3482,Jiri Novak,Clay,128,99,227,604,56.39
3483,Jiri Novak,Grass,17,18,35,604,48.57
3484,Jiri Novak,Hard,156,116,272,604,57.35
3485,Jiri Prucha,Clay,3,7,10,10,30.0
3486,Jiri Vanek,Carpet,1,7,8,190,12.5
3487,Jiri Vanek,Clay,48,66,114,190,42.11
3488,Jiri Vanek,Grass,1,7,8,190,12.5
3489,Jiri Vanek,Hard,18,42,60,190,30.0
3490,Jiri Vesely,Clay,55,55,110,270,50.0
3491,Jiri Vesely,Grass,18,12,30,270,60.0
3492,Jiri Vesely,Hard,54,76,130,270,41.54
3493,Jiri Zigmund,Grass,1,1,2,2,50.0
3494,Jiu Hua Zhang,Clay,1,1,2,9,50.0
3495,Jiu Hua Zhang,Hard,5,2,7,9,71.43
3496,Jo-Wilfried Tsonga,Carpet,9,3,12,696,75.0
3497,Jo-Wilfried Tsonga,Clay,89,53,142,696,62.68
3498,Jo-Wilfried Tsonga,Grass,52,23,75,696,69.33
3499,Jo-Wilfried Tsonga,Hard,319,148,467,696,68.31
3500,Joachim Johansson,Carpet,4,3,7,133,57.14
3501,Joachim Johansson,Clay,3,14,17,133,17.65
3502,Joachim Johansson,Grass,6,6,12,133,50.0
3503,Joachim Johansson,Hard,59,38,97,133,60.82
3504,Joakim Nystrom,Carpet,39,24,63,409,61.9
3505,Joakim Nystrom,Clay,143,75,218,409,65.6
3506,Joakim Nystrom,Grass,23,14,37,409,62.16
3507,Joakim Nystrom,Hard,60,31,91,409,65.93
3508,Joan Jimenez Guerra,Carpet,1,3,4,4,25.0
3509,Joao Cunha Silva,Carpet,6,9,15,138,40.0
3510,Joao Cunha Silva,Clay,28,58,86,138,32.56
3511,Joao Cunha Silva,Grass,1,4,5,138,20.0
3512,Joao Cunha Silva,Hard,13,19,32,138,40.62
3513,Joao Domingues,Clay,6,6,12,14,50.0
3514,Joao Domingues,Hard,1,1,2,14,50.0
3515,Joao Lagos,Clay,2,5,7,7,28.57
3516,Joao Pedro Sorgi,Hard,1,2,3,3,33.33
3517,Joao Soares,Carpet,8,11,19,144,42.11
3518,Joao Soares,Clay,19,46,65,144,29.23
3519,Joao Soares,Grass,7,14,21,144,33.33
3520,Joao Soares,Hard,9,30,39,144,23.08
3521,Joao Sousa,Clay,79,81,160,416,49.38
3522,Joao Sousa,Grass,14,20,34,416,41.18
3523,Joao Sousa,Hard,100,122,222,416,45.05
3524,Joao Souza,Clay,26,42,68,76,38.24
3525,Joao Souza,Hard,1,7,8,76,12.5
3526,Joao Zwetsch,Carpet,1,1,2,2,50.0
3527,Joaquim Rasgado Jr,Clay,2,6,8,8,25.0
3528,Joaquin Loyo Mayo,Carpet,5,16,21,206,23.81
3529,Joaquin Loyo Mayo,Clay,40,53,93,206,43.01
3530,Joaquin Loyo Mayo,Grass,21,20,41,206,51.22
3531,Joaquin Loyo Mayo,Hard,16,35,51,206,31.37
3532,Joe Meyers,Clay,1,3,4,8,25.0
3533,Joe Meyers,Grass,1,1,2,8,50.0
3534,Joe Meyers,Hard,1,1,2,8,50.0
3535,Joel Bailey,Carpet,1,11,12,37,8.33
3536,Joel Bailey,Clay,3,7,10,37,30.0
3537,Joel Bailey,Hard,3,12,15,37,20.0
3538,Joern Renzenbrink,Carpet,5,9,14,88,35.71
3539,Joern Renzenbrink,Clay,3,9,12,88,25.0
3540,Joern Renzenbrink,Grass,2,9,11,88,18.18
3541,Joern Renzenbrink,Hard,24,27,51,88,47.06
3542,Joey Blake,Hard,2,2,4,4,50.0
3543,Joey Rive,Carpet,8,10,18,134,44.44
3544,Joey Rive,Clay,3,9,12,134,25.0
3545,Joey Rive,Grass,12,11,23,134,52.17
3546,Joey Rive,Hard,34,47,81,134,41.98
3547,Johan Anderson,Carpet,1,2,3,64,33.33
3548,Johan Anderson,Clay,8,8,16,64,50.0
3549,Johan Anderson,Grass,1,4,5,64,20.0
3550,Johan Anderson,Hard,16,24,40,64,40.0
3551,Johan Carlsson,Carpet,3,8,11,132,27.27
3552,Johan Carlsson,Clay,7,16,23,132,30.43
3553,Johan Carlsson,Grass,2,4,6,132,33.33
3554,Johan Carlsson,Hard,43,49,92,132,46.74
3555,Johan Kriek,Carpet,101,64,165,603,61.21
3556,Johan Kriek,Clay,26,26,52,603,50.0
3557,Johan Kriek,Grass,85,32,117,603,72.65
3558,Johan Kriek,Hard,168,101,269,603,62.45
3559,Johan Ortegren,Hard,1,1,2,2,50.0
3560,Johan Settergren,Clay,2,2,4,4,50.0
3561,Johan Van Herck,Carpet,12,15,27,122,44.44
3562,Johan Van Herck,Clay,26,29,55,122,47.27
3563,Johan Van Herck,Hard,14,26,40,122,35.0
3564,John Alexander,Carpet,98,109,207,945,47.34
3565,John Alexander,Clay,199,120,319,945,62.38
3566,John Alexander,Grass,122,83,205,945,59.51
3567,John Alexander,Hard,123,91,214,945,57.48
3568,John Andrews,Carpet,2,8,10,78,20.0
3569,John Andrews,Clay,15,17,32,78,46.88
3570,John Andrews,Grass,6,10,16,78,37.5
3571,John Andrews,Hard,8,12,20,78,40.0
3572,John Antonas,Hard,1,4,5,5,20.0
3573,John Austin,Carpet,13,25,38,142,34.21
3574,John Austin,Clay,3,8,11,142,27.27
3575,John Austin,Grass,8,17,25,142,32.0
3576,John Austin,Hard,30,38,68,142,44.12
3577,John Barrett,Clay,3,8,11,18,27.27
3578,John Barrett,Grass,2,5,7,18,28.57
3579,John Bartlett,Carpet,1,3,4,117,25.0
3580,John Bartlett,Clay,13,41,54,117,24.07
3581,John Bartlett,Grass,13,28,41,117,31.71
3582,John Bartlett,Hard,2,16,18,117,11.11
3583,John Benson,Carpet,1,2,3,6,33.33
3584,John Benson,Clay,1,2,3,6,33.33
3585,John Brown,Clay,1,2,3,21,33.33
3586,John Brown,Grass,4,9,13,21,30.77
3587,John Brown,Hard,2,3,5,21,40.0
3588,John Chris Lewis,Carpet,1,2,3,13,33.33
3589,John Chris Lewis,Clay,1,3,4,13,25.0
3590,John Chris Lewis,Hard,1,5,6,13,16.67
3591,John Clifton,Carpet,1,1,2,32,50.0
3592,John Clifton,Clay,3,10,13,32,23.08
3593,John Clifton,Grass,5,12,17,32,29.41
3594,John Cooper,Clay,6,15,21,131,28.57
3595,John Cooper,Grass,35,24,59,131,59.32
3596,John Cooper,Hard,26,25,51,131,50.98
3597,John Davis,Hard,1,1,2,2,50.0
3598,John De Mendoza,Carpet,1,1,2,14,50.0
3599,John De Mendoza,Clay,1,2,3,14,33.33
3600,John De Mendoza,Grass,3,6,9,14,33.33
3601,John Doran,Carpet,3,1,4,14,75.0
3602,John Doran,Clay,3,4,7,14,42.86
3603,John Doran,Hard,2,1,3,14,66.67
3604,John Eagleton,Hard,1,1,2,2,50.0
3605,John Eastburn,Grass,1,3,4,4,25.0
3606,John Erik Rustad,Carpet,2,2,4,4,50.0
3607,John Farrington,Clay,1,3,4,15,25.0
3608,John Farrington,Hard,3,8,11,15,27.27
3609,John Feaver,Carpet,10,30,40,225,25.0
3610,John Feaver,Clay,27,66,93,225,29.03
3611,John Feaver,Grass,21,43,64,225,32.81
3612,John Feaver,Hard,6,22,28,225,21.43
3613,John Fitzgerald,Carpet,41,40,81,473,50.62
3614,John Fitzgerald,Clay,10,26,36,473,27.78
3615,John Fitzgerald,Grass,98,69,167,473,58.68
3616,John Fitzgerald,Hard,92,97,189,473,48.68
3617,John Fort,Grass,1,2,3,3,33.33
3618,John Fraser,Grass,2,1,3,3,66.67
3619,John Frawley,Carpet,5,10,15,158,33.33
3620,John Frawley,Clay,13,17,30,158,43.33
3621,John Frawley,Grass,12,21,33,158,36.36
3622,John Frawley,Hard,39,41,80,158,48.75
3623,John Gardner,Clay,2,4,6,16,33.33
3624,John Gardner,Grass,2,2,4,16,50.0
3625,John Gardner,Hard,1,5,6,16,16.67
3626,John Gavan Fraser,Grass,1,1,2,2,50.0
3627,John Hayes,Carpet,1,3,4,43,25.0
3628,John Hayes,Clay,8,10,18,43,44.44
3629,John Hayes,Hard,7,14,21,43,33.33
3630,John Holladay,Carpet,2,7,9,23,22.22
3631,John Holladay,Clay,1,4,5,23,20.0
3632,John Holladay,Grass,2,7,9,23,22.22
3633,John Hui,Hard,3,8,11,11,27.27
3634,John Isner,Clay,70,59,129,704,54.26
3635,John Isner,Grass,49,24,73,704,67.12
3636,John Isner,Hard,314,188,502,704,62.55
3637,John James,Carpet,8,20,28,230,28.57
3638,John James,Clay,24,44,68,230,35.29
3639,John James,Grass,38,44,82,230,46.34
3640,John James,Hard,20,32,52,230,38.46
3641,John Letts,Carpet,2,2,4,14,50.0
3642,John Letts,Grass,1,1,2,14,50.0
3643,John Letts,Hard,1,7,8,14,12.5
3644,John Lloyd,Carpet,39,54,93,485,41.94
3645,John Lloyd,Clay,57,82,139,485,41.01
3646,John Lloyd,Grass,59,61,120,485,49.17
3647,John Lloyd,Hard,61,72,133,485,45.86
3648,John Maginley,Hard,1,3,4,4,25.0
3649,John Marks,Clay,6,27,33,102,18.18
3650,John Marks,Grass,18,31,49,102,36.73
3651,John Marks,Hard,4,16,20,102,20.0
3652,John Mattke,Clay,2,2,4,13,50.0
3653,John Mattke,Grass,1,3,4,13,25.0
3654,John Mattke,Hard,2,3,5,13,40.0
3655,John McDonald,Grass,4,7,11,11,36.36
3656,John McEnroe,Carpet,350,63,413,1083,84.75
3657,John McEnroe,Clay,123,48,171,1083,71.93
3658,John McEnroe,Grass,121,20,141,1083,85.82
3659,John McEnroe,Hard,290,68,358,1083,81.01
3660,John Mccurdy,Grass,5,6,11,19,45.45
3661,John Mccurdy,Hard,1,7,8,19,12.5
3662,John Mcgrath,Grass,3,3,6,6,50.0
3663,John Mcmanus,Clay,1,1,2,2,50.0
3664,John Millman,Clay,11,19,30,194,36.67
3665,John Millman,Grass,10,13,23,194,43.48
3666,John Millman,Hard,67,74,141,194,47.52
3667,John Mills,Hard,1,1,2,2,50.0
3668,John Muller,Hard,2,3,5,5,40.0
3669,John Newcombe,Carpet,85,43,128,648,66.41
3670,John Newcombe,Clay,114,45,159,648,71.7
3671,John Newcombe,Grass,145,40,185,648,78.38
3672,John Newcombe,Hard,125,51,176,648,71.02
3673,John Paish,Carpet,1,3,4,78,25.0
3674,John Paish,Clay,6,19,25,78,24.0
3675,John Paish,Grass,15,21,36,78,41.67
3676,John Paish,Hard,4,9,13,78,30.77
3677,John Patrick Smith,Grass,4,5,9,27,44.44
3678,John Patrick Smith,Hard,1,17,18,27,5.56
3679,John Picken,Clay,2,2,4,7,50.0
3680,John Picken,Hard,1,2,3,7,33.33
3681,John Ross,Clay,5,14,19,73,26.32
3682,John Ross,Grass,2,3,5,73,40.0
3683,John Ross,Hard,18,31,49,73,36.73
3684,John Sadri,Carpet,74,66,140,403,52.86
3685,John Sadri,Clay,14,15,29,403,48.28
3686,John Sadri,Grass,68,46,114,403,59.65
3687,John Sadri,Hard,58,62,120,403,48.33
3688,John Sharpe,Clay,4,10,14,20,28.57
3689,John Sharpe,Grass,2,4,6,20,33.33
3690,John Sobel,Clay,1,3,4,7,25.0
3691,John Sobel,Hard,1,2,3,7,33.33
3692,John Stephens,Grass,2,4,6,6,33.33
3693,John Stimpson,Hard,1,2,3,3,33.33
3694,John Stoddart,Grass,1,1,2,2,50.0
3695,John Sullivan,Hard,1,2,3,3,33.33
3696,John Trickey,Grass,4,15,19,19,21.05
3697,John Van Lottum,Carpet,4,9,13,162,30.77
3698,John Van Lottum,Clay,13,29,42,162,30.95
3699,John Van Lottum,Grass,13,16,29,162,44.83
3700,John Van Lottum,Hard,32,46,78,162,41.03
3701,John Van Nostrand,Grass,2,1,3,3,66.67
3702,John Ward,Clay,1,2,3,3,33.33
3703,John Whitlinger,Carpet,11,17,28,120,39.29
3704,John Whitlinger,Clay,13,29,42,120,30.95
3705,John Whitlinger,Grass,5,6,11,120,45.45
3706,John Whitlinger,Hard,15,24,39,120,38.46
3707,John Williams,Grass,1,1,2,2,50.0
3708,John Yeomans,Hard,1,3,4,4,25.0
3709,John Yuill,Carpet,12,17,29,221,41.38
3710,John Yuill,Clay,45,69,114,221,39.47
3711,John Yuill,Grass,9,12,21,221,42.86
3712,John Yuill,Hard,22,35,57,221,38.6
3713,Johnny Arcilla,Clay,10,11,21,28,47.62
3714,Johnny Arcilla,Hard,3,4,7,28,42.86
3715,Johnny Goudenbour,Carpet,5,2,7,42,71.43
3716,Johnny Goudenbour,Clay,6,15,21,42,28.57
3717,Johnny Goudenbour,Hard,6,8,14,42,42.86
3718,Johny De Leon,Clay,2,1,3,3,66.67
3719,Jon Hainline,Clay,1,3,4,4,25.0
3720,Jon Levine,Clay,4,12,16,42,25.0
3721,Jon Levine,Grass,1,3,4,42,25.0
3722,Jon Levine,Hard,5,17,22,42,22.73
3723,Jonas Bjorkman,Carpet,57,45,102,778,55.88
3724,Jonas Bjorkman,Clay,36,64,100,778,36.0
3725,Jonas Bjorkman,Grass,82,44,126,778,65.08
3726,Jonas Bjorkman,Hard,241,209,450,778,53.56
3727,Jonas Forejtek,Hard,3,1,4,4,75.0
3728,Jonas Froberg,Hard,1,1,2,2,50.0
3729,Jonas Svensson,Carpet,91,58,149,465,61.07
3730,Jonas Svensson,Clay,68,70,138,465,49.28
3731,Jonas Svensson,Grass,12,12,24,465,50.0
3732,Jonas Svensson,Hard,90,64,154,465,58.44
3733,Jonathan Canter,Carpet,9,18,27,164,33.33
3734,Jonathan Canter,Clay,3,11,14,164,21.43
3735,Jonathan Canter,Grass,9,15,24,164,37.5
3736,Jonathan Canter,Hard,47,52,99,164,47.47
3737,Jonathan Chu,Hard,3,1,4,4,75.0
3738,Jonathan Dasnieres De Veigy,Clay,1,3,4,4,25.0
3739,Jonathan Erlich,Grass,1,2,3,12,33.33
3740,Jonathan Erlich,Hard,5,4,9,12,55.56
3741,Jonathan Marray,Grass,4,7,11,11,36.36
3742,Jonathan Mridha,Hard,1,1,2,2,50.0
3743,Jonathan Printzlau,Hard,1,1,2,2,50.0
3744,Jonathan Smith,Carpet,3,4,7,110,42.86
3745,Jonathan Smith,Clay,11,19,30,110,36.67
3746,Jonathan Smith,Grass,19,34,53,110,35.85
3747,Jonathan Smith,Hard,6,14,20,110,30.0
3748,Jonathan Stark,Carpet,23,16,39,287,58.97
3749,Jonathan Stark,Clay,7,12,19,287,36.84
3750,Jonathan Stark,Grass,21,22,43,287,48.84
3751,Jonathan Stark,Hard,85,101,186,287,45.7
3752,Joost Winnink,Carpet,5,7,12,23,41.67
3753,Joost Winnink,Clay,1,3,4,23,25.0
3754,Joost Winnink,Hard,2,5,7,23,28.57
3755,Jordan Thompson,Clay,8,13,21,133,38.1
3756,Jordan Thompson,Grass,8,13,21,133,38.1
3757,Jordan Thompson,Hard,41,50,91,133,45.05
3758,Jordi Arrese,Clay,214,185,399,424,53.63
3759,Jordi Arrese,Hard,11,14,25,424,44.0
3760,Jordi Burillo,Clay,70,79,149,217,46.98
3761,Jordi Burillo,Grass,7,7,14,217,50.0
3762,Jordi Burillo,Hard,15,39,54,217,27.78
3763,Jordi Mas,Clay,1,3,4,4,25.0
3764,Jorge Aguilar,Clay,4,6,10,10,40.0
3765,Jorge Andrew,Carpet,7,9,16,143,43.75
3766,Jorge Andrew,Clay,16,62,78,143,20.51
3767,Jorge Andrew,Grass,4,11,15,143,26.67
3768,Jorge Andrew,Hard,6,28,34,143,17.65
3769,Jorge Bardou,Clay,9,25,34,37,26.47
3770,Jorge Bardou,Hard,1,2,3,37,33.33
3771,Jorge Brian Panta Herreros,Clay,3,2,5,5,60.0
3772,Jorge Catala,Hard,1,2,3,3,33.33
3773,Jorge Gonzalez,Clay,1,4,5,11,20.0
3774,Jorge Gonzalez,Hard,3,3,6,11,50.0
3775,Jorge Lozano,Carpet,7,8,15,76,46.67
3776,Jorge Lozano,Clay,6,15,21,76,28.57
3777,Jorge Lozano,Hard,15,25,40,76,37.5
3778,Jorgen Ulrich,Clay,6,14,20,31,30.0
3779,Jorgen Ulrich,Grass,2,6,8,31,25.0
3780,Jorgen Ulrich,Hard,1,2,3,31,33.33
3781,Jorgen Windahl,Carpet,2,2,4,39,50.0
3782,Jorgen Windahl,Clay,9,16,25,39,36.0
3783,Jorgen Windahl,Hard,2,8,10,39,20.0
3784,Joris De Loore,Hard,1,3,4,4,25.0
3785,Jose Acasuso,Carpet,5,6,11,368,45.45
3786,Jose Acasuso,Clay,146,101,247,368,59.11
3787,Jose Acasuso,Hard,42,68,110,368,38.18
3788,Jose Andrade,Clay,1,1,2,2,50.0
3789,Jose Antonio Fernandez,Clay,5,6,11,15,45.45
3790,Jose Antonio Fernandez,Hard,3,1,4,15,75.0
3791,Jose Antonio Pepe Conde,Clay,3,8,11,11,27.27
3792,Jose Baires,Clay,1,2,3,3,33.33
3793,Jose Benitez,Clay,1,1,2,2,50.0
3794,Jose Bernard,Clay,1,1,2,2,50.0
3795,Jose Castanon,Clay,2,19,21,23,9.52
3796,Jose Castanon,Grass,1,1,2,23,50.0
3797,Jose Clavet,Clay,6,11,17,17,35.29
3798,Jose Daher,Carpet,1,2,3,14,33.33
3799,Jose Daher,Hard,3,8,11,14,27.27
3800,Jose De Armas,Clay,4,7,11,36,36.36
3801,Jose De Armas,Hard,15,10,25,36,60.0
3802,Jose Francisco Altur,Carpet,3,5,8,92,37.5
3803,Jose Francisco Altur,Clay,26,41,67,92,38.81
3804,Jose Francisco Altur,Hard,2,15,17,92,11.76
3805,Jose Garcia,Clay,8,17,25,25,32.0
3806,Jose Guerrero,Clay,7,18,25,25,28.0
3807,Jose Hernandez,Clay,5,9,14,25,35.71
3808,Jose Hernandez,Hard,5,6,11,25,45.45
3809,Jose Higueras,Carpet,28,27,55,683,50.91
3810,Jose Higueras,Clay,385,183,568,683,67.78
3811,Jose Higueras,Grass,4,4,8,683,50.0
3812,Jose Higueras,Hard,29,23,52,683,55.77
3813,Jose Imaz Ruiz,Clay,3,6,9,9,33.33
3814,Jose Lopez Maeso,Carpet,5,3,8,163,62.5
3815,Jose Lopez Maeso,Clay,52,73,125,163,41.6
3816,Jose Lopez Maeso,Grass,3,6,9,163,33.33
3817,Jose Lopez Maeso,Hard,8,13,21,163,38.1
3818,Jose Luis Aparisi,Clay,3,8,11,11,27.27
3819,Jose Luis Arillla,Clay,6,16,22,24,27.27
3820,Jose Luis Arillla,Grass,1,1,2,24,50.0
3821,Jose Luis Clerc,Carpet,22,37,59,539,37.29
3822,Jose Luis Clerc,Clay,305,92,397,539,76.83
3823,Jose Luis Clerc,Grass,11,10,21,539,52.38
3824,Jose Luis Clerc,Hard,44,18,62,539,70.97
3825,Jose Luis Damiani,Carpet,2,7,9,129,22.22
3826,Jose Luis Damiani,Clay,53,57,110,129,48.18
3827,Jose Luis Damiani,Grass,1,1,2,129,50.0
3828,Jose Luis Damiani,Hard,2,6,8,129,25.0
3829,Jose Luis Noriega,Clay,1,4,5,5,20.0
3830,Jose Mandarino,Carpet,1,6,7,67,14.29
3831,Jose Mandarino,Clay,15,22,37,67,40.54
3832,Jose Mandarino,Grass,5,11,16,67,31.25
3833,Jose Mandarino,Hard,2,5,7,67,28.57
3834,Jose Manuel Dominguez,Clay,1,1,2,2,50.0
3835,Jose Maria Gisbert,Clay,1,2,3,3,33.33
3836,Jose Medrano,Clay,2,4,6,8,33.33
3837,Jose Medrano,Hard,1,1,2,8,50.0
3838,Jose Moreno,Clay,8,24,32,34,25.0
3839,Jose Moreno,Grass,1,1,2,34,50.0
3840,Jose Prats,Clay,1,1,2,2,50.0
3841,Jose Roberto Velasco,Clay,1,3,4,4,25.0
3842,Jose Rubin Statham,Carpet,2,1,3,43,66.67
3843,Jose Rubin Statham,Clay,4,3,7,43,57.14
3844,Jose Rubin Statham,Hard,17,16,33,43,51.52
3845,Jose Vilela,Clay,8,10,18,18,44.44
3846,Josef Brabenec,Hard,2,1,3,3,66.67
3847,Josef Cihak,Clay,16,23,39,42,41.03
3848,Josef Cihak,Hard,2,1,3,42,66.67
3849,Josef Stabholz,Clay,2,4,6,14,33.33
3850,Josef Stabholz,Hard,2,6,8,14,25.0
3851,Joseph Lizardo,Clay,7,4,11,23,63.64
3852,Joseph Lizardo,Hard,5,7,12,23,41.67
3853,Joseph Russell,Hard,2,1,3,3,66.67
3854,Joseph Sirianni,Grass,1,4,5,21,20.0
3855,Joseph Sirianni,Hard,6,10,16,21,37.5
3856,Joseph Victorino,Clay,1,4,5,5,20.0
3857,Joshua Eagle,Carpet,1,3,4,14,25.0
3858,Joshua Eagle,Grass,1,3,4,14,25.0
3859,Joshua Eagle,Hard,1,5,6,14,16.67
3860,Joshua Goodall,Grass,1,8,9,9,11.11
3861,Josselin Ouanna,Carpet,2,1,3,26,66.67
3862,Josselin Ouanna,Clay,4,7,11,26,36.36
3863,Josselin Ouanna,Hard,3,9,12,26,25.0
3864,Jozef Kovalik,Clay,10,21,31,50,32.26
3865,Jozef Kovalik,Hard,7,12,19,50,36.84
3866,Jozsef Krocsko,Carpet,1,9,10,30,10.0
3867,Jozsef Krocsko,Clay,9,9,18,30,50.0
3868,Jozsef Krocsko,Hard,1,1,2,30,50.0
3869,Juan Aguilera,Carpet,3,11,14,288,21.43
3870,Juan Aguilera,Clay,137,114,251,288,54.58
3871,Juan Aguilera,Grass,2,2,4,288,50.0
3872,Juan Aguilera,Hard,5,14,19,288,26.32
3873,Juan Albert Viloca Puig,Clay,41,52,93,125,44.09
3874,Juan Albert Viloca Puig,Grass,1,2,3,125,33.33
3875,Juan Albert Viloca Puig,Hard,6,23,29,125,20.69
3876,Juan Antonio Marin,Clay,71,91,162,195,43.83
3877,Juan Antonio Marin,Hard,9,24,33,195,27.27
3878,Juan Antonio Rodriguez,Clay,1,7,8,11,12.5
3879,Juan Antonio Rodriguez,Hard,1,2,3,11,33.33
3880,Juan Avendano,Clay,38,68,106,114,35.85
3881,Juan Avendano,Hard,2,6,8,114,25.0
3882,Juan Balcells,Clay,26,24,50,85,52.0
3883,Juan Balcells,Hard,15,20,35,85,42.86
3884,Juan Carlos Arroyo,Clay,1,1,2,2,50.0
3885,Juan Carlos Ayala,Hard,1,2,3,3,33.33
3886,Juan Carlos Baguena,Clay,3,16,19,19,15.79
3887,Juan Carlos Ferrero,Carpet,17,14,31,741,54.84
3888,Juan Carlos Ferrero,Clay,254,95,349,741,72.78
3889,Juan Carlos Ferrero,Grass,30,19,49,741,61.22
3890,Juan Carlos Ferrero,Hard,178,134,312,741,57.05
3891,Juan Carlos Ramirez,Clay,2,6,8,13,25.0
3892,Juan Carlos Ramirez,Hard,2,3,5,13,40.0
3893,Juan Couder,Clay,3,5,8,8,37.5
3894,Juan Garat,Clay,1,6,7,7,14.29
3895,Juan Giner,Clay,2,3,5,5,40.0
3896,Juan Gisbert,Carpet,16,16,32,321,50.0
3897,Juan Gisbert,Clay,121,95,216,321,56.02
3898,Juan Gisbert,Grass,8,4,12,321,66.67
3899,Juan Gisbert,Hard,33,28,61,321,54.1
3900,Juan Gisbert Jr,Clay,5,12,17,17,29.41
3901,Juan Hernandez,Carpet,2,1,3,3,66.67
3902,Juan Herrera,Clay,5,13,18,18,27.78
3903,Juan Ignacio Chela,Carpet,4,10,14,605,28.57
3904,Juan Ignacio Chela,Clay,198,134,332,605,59.64
3905,Juan Ignacio Chela,Grass,4,11,15,605,26.67
3906,Juan Ignacio Chela,Hard,122,122,244,605,50.0
3907,Juan Ignacio Londero,Clay,26,20,46,68,56.52
3908,Juan Ignacio Londero,Grass,1,2,3,68,33.33
3909,Juan Ignacio Londero,Hard,4,15,19,68,21.05
3910,Juan Ignacio Muntanola,Clay,16,25,41,45,39.02
3911,Juan Ignacio Muntanola,Hard,2,2,4,45,50.0
3912,Juan Luis Tati Rascon,Carpet,1,2,3,7,33.33
3913,Juan Luis Tati Rascon,Hard,1,3,4,7,25.0
3914,Juan Martin del Potro,Carpet,6,2,8,620,75.0
3915,Juan Martin del Potro,Clay,84,37,121,620,69.42
3916,Juan Martin del Potro,Grass,40,18,58,620,68.97
3917,Juan Martin del Potro,Hard,313,120,433,620,72.29
3918,Juan Monaco,Carpet,4,8,12,616,33.33
3919,Juan Monaco,Clay,236,143,379,616,62.27
3920,Juan Monaco,Grass,7,11,18,616,38.89
3921,Juan Monaco,Hard,96,111,207,616,46.38
3922,Juan Nunez,Clay,9,14,23,27,39.13
3923,Juan Nunez,Hard,1,3,4,27,25.0
3924,Juan Pablo Brzezicki,Clay,6,15,21,21,28.57
3925,Juan Pablo Guzman,Clay,5,13,18,21,27.78
3926,Juan Pablo Guzman,Hard,1,2,3,21,33.33
3927,Juan Pablo Varillas,Clay,5,4,9,13,55.56
3928,Juan Pablo Varillas,Hard,1,3,4,13,25.0
3929,Juan Pino,Clay,8,5,13,34,61.54
3930,Juan Pino,Hard,13,8,21,34,61.9
3931,Juan Sebastian Cabal,Clay,6,3,9,11,66.67
3932,Juan Sebastian Cabal,Hard,1,1,2,11,50.0
3933,Juan Sebastian Langton,Hard,3,7,10,10,30.0
3934,Juan Torralbo,Clay,2,4,6,6,33.33
3935,Juho Paukku,Clay,1,2,3,3,33.33
3936,Jui Chen Hung,Hard,4,4,8,8,50.0
3937,Julen Uriguen,Hard,2,1,3,3,66.67
3938,Julian Alonso,Carpet,2,2,4,114,50.0
3939,Julian Alonso,Clay,40,38,78,114,51.28
3940,Julian Alonso,Hard,10,22,32,114,31.25
3941,Julian Ganzabal,Carpet,1,2,3,129,33.33
3942,Julian Ganzabal,Clay,50,57,107,129,46.73
3943,Julian Ganzabal,Grass,4,5,9,129,44.44
3944,Julian Ganzabal,Hard,4,6,10,129,40.0
3945,Julian Knowle,Clay,2,12,14,42,14.29
3946,Julian Knowle,Grass,4,8,12,42,33.33
3947,Julian Knowle,Hard,3,13,16,42,18.75
3948,Julian Krinsky,Hard,6,5,11,11,54.55
3949,Julian Mayers,Hard,1,1,2,2,50.0
3950,Julian Reister,Clay,11,21,32,41,34.38
3951,Julian Reister,Grass,3,6,9,41,33.33
3952,Julian Stamatov,Clay,12,8,20,20,60.0
3953,Julien Benneteau,Carpet,14,12,26,569,53.85
3954,Julien Benneteau,Clay,46,65,111,569,41.44
3955,Julien Benneteau,Grass,36,40,76,569,47.37
3956,Julien Benneteau,Hard,176,180,356,569,49.44
3957,Julien Boutter,Carpet,10,10,20,146,50.0
3958,Julien Boutter,Clay,30,28,58,146,51.72
3959,Julien Boutter,Grass,1,8,9,146,11.11
3960,Julien Boutter,Hard,21,38,59,146,35.59
3961,Julien Jeanpierre,Clay,2,1,3,5,66.67
3962,Julien Jeanpierre,Hard,1,1,2,5,50.0
3963,Julien Varlet,Carpet,2,1,3,7,66.67
3964,Julien Varlet,Clay,1,3,4,7,25.0
3965,Julio Cesar Campozano,Clay,9,7,16,24,56.25
3966,Julio Cesar Campozano,Hard,3,5,8,24,37.5
3967,Julio Goes,Carpet,2,2,4,48,50.0
3968,Julio Goes,Clay,3,23,26,48,11.54
3969,Julio Goes,Hard,7,11,18,48,38.89
3970,Julio Silva,Clay,3,7,10,10,30.0
3971,Julio Van Kerckhoven,Clay,1,2,3,3,33.33
3972,Jun Kamiwazumi,Carpet,5,14,19,164,26.32
3973,Jun Kamiwazumi,Clay,34,42,76,164,44.74
3974,Jun Kamiwazumi,Grass,13,21,34,164,38.24
3975,Jun Kamiwazumi,Hard,13,22,35,164,37.14
3976,Jun Kuki,Carpet,2,8,10,184,20.0
3977,Jun Kuki,Clay,45,76,121,184,37.19
3978,Jun Kuki,Grass,5,15,20,184,25.0
3979,Jun Kuki,Hard,13,20,33,184,39.39
3980,Junie Chatman,Clay,2,3,5,5,40.0
3981,Jurabek Karimov,Clay,1,1,2,2,50.0
3982,Jurek Stasiak,Hard,1,2,3,3,33.33
3983,Jurgen Fassbender,Carpet,22,16,38,307,57.89
3984,Jurgen Fassbender,Clay,84,83,167,307,50.3
3985,Jurgen Fassbender,Grass,15,17,32,307,46.88
3986,Jurgen Fassbender,Hard,37,33,70,307,52.86
3987,Jurgen Melzer,Carpet,8,12,20,689,40.0
3988,Jurgen Melzer,Clay,124,114,238,689,52.1
3989,Jurgen Melzer,Grass,39,35,74,689,52.7
3990,Jurgen Melzer,Hard,182,175,357,689,50.98
3991,Jurgen Zopp,Carpet,1,3,4,59,25.0
3992,Jurgen Zopp,Clay,11,14,25,59,44.0
3993,Jurgen Zopp,Hard,12,18,30,59,40.0
3994,Jurij Rodionov,Clay,1,5,6,9,16.67
3995,Jurij Rodionov,Hard,1,2,3,9,33.33
3996,Justedjo Tarik,Carpet,1,5,6,17,16.67
3997,Justedjo Tarik,Clay,6,2,8,17,75.0
3998,Justedjo Tarik,Hard,2,1,3,17,66.67
3999,Justin Bower,Clay,1,5,6,11,16.67
4000,Justin Bower,Grass,1,2,3,11,33.33
4001,Justin Bower,Hard,1,1,2,11,50.0
4002,Justin Gimelstob,Carpet,4,7,11,279,36.36
4003,Justin Gimelstob,Clay,8,17,25,279,32.0
4004,Justin Gimelstob,Grass,24,35,59,279,40.68
4005,Justin Gimelstob,Hard,71,113,184,279,38.59
4006,K Javan,Clay,1,2,3,3,33.33
4007,Kacper Zuk,Hard,2,2,4,4,50.0
4008,Kadhim Kadhim,Hard,2,2,4,4,50.0
4009,Kalle Flygt,Hard,2,2,4,4,50.0
4010,Kamil Majchrzak,Clay,2,4,6,28,33.33
4011,Kamil Majchrzak,Grass,1,3,4,28,25.0
4012,Kamil Majchrzak,Hard,6,12,18,28,33.33
4013,Kanyab Derafshidjavan,Clay,1,2,3,3,33.33
4014,Karan Rastogi,Hard,1,6,7,7,14.29
4015,Karel Demuynck,Carpet,2,6,8,13,25.0
4016,Karel Demuynck,Clay,2,3,5,13,40.0
4017,Karel Novacek,Carpet,47,58,105,546,44.76
4018,Karel Novacek,Clay,188,117,305,546,61.64
4019,Karel Novacek,Grass,10,14,24,546,41.67
4020,Karel Novacek,Hard,55,57,112,546,49.11
4021,Karen Khachanov,Clay,36,27,63,252,57.14
4022,Karen Khachanov,Grass,14,7,21,252,66.67
4023,Karen Khachanov,Hard,91,77,168,252,54.17
4024,Karim Alami,Carpet,1,17,18,352,5.56
4025,Karim Alami,Clay,127,112,239,352,53.14
4026,Karim Alami,Grass,5,10,15,352,33.33
4027,Karim Alami,Hard,30,50,80,352,37.5
4028,Karim Alayli,Clay,2,7,9,23,22.22
4029,Karim Alayli,Hard,1,13,14,23,7.14
4030,Karim Maamoun,Carpet,2,5,7,26,28.57
4031,Karim Maamoun,Clay,7,7,14,26,50.0
4032,Karim Maamoun,Hard,1,4,5,26,20.0
4033,Karim Mohamed Maamoun,Clay,2,5,7,11,28.57
4034,Karim Mohamed Maamoun,Hard,2,2,4,11,50.0
4035,Karl Coombes,Hard,2,3,5,5,40.0
4036,Karl Fichtel,Clay,1,4,5,5,20.0
4037,Karl Hale,Hard,1,6,7,7,14.29
4038,Karl Meiler,Carpet,32,28,60,403,53.33
4039,Karl Meiler,Clay,109,91,200,403,54.5
4040,Karl Meiler,Grass,26,22,48,403,54.17
4041,Karl Meiler,Hard,54,41,95,403,56.84
4042,Karl Richter,Hard,1,5,6,6,16.67
4043,Karlis Lejnieks,Carpet,2,2,4,7,50.0
4044,Karlis Lejnieks,Hard,1,2,3,7,33.33
4045,Karol Beck,Carpet,9,7,16,181,56.25
4046,Karol Beck,Clay,2,20,22,181,9.09
4047,Karol Beck,Grass,14,18,32,181,43.75
4048,Karol Beck,Hard,40,71,111,181,36.04
4049,Karol Kucera,Carpet,57,36,93,538,61.29
4050,Karol Kucera,Clay,76,84,160,538,47.5
4051,Karol Kucera,Grass,37,25,62,538,59.68
4052,Karol Kucera,Hard,123,100,223,538,55.16
4053,Karsten Braasch,Carpet,7,11,18,164,38.89
4054,Karsten Braasch,Clay,15,29,44,164,34.09
4055,Karsten Braasch,Grass,11,14,25,164,44.0
4056,Karsten Braasch,Hard,35,42,77,164,45.45
4057,Karsten Schulz,Hard,1,1,2,2,50.0
4058,Ke Qin Ma,Carpet,1,3,4,10,25.0
4059,Ke Qin Ma,Clay,3,3,6,10,50.0
4060,Kei Nishikori,Clay,97,44,141,606,68.79
4061,Kei Nishikori,Grass,40,26,66,606,60.61
4062,Kei Nishikori,Hard,267,132,399,606,66.92
4063,Keith Brebnor,Hard,1,4,5,5,20.0
4064,Keith Carpenter,Clay,1,6,7,7,14.29
4065,Keith Diepraam,Clay,1,2,3,20,33.33
4066,Keith Diepraam,Grass,3,4,7,20,42.86
4067,Keith Diepraam,Hard,5,5,10,20,50.0
4068,Keith Evans,Hard,2,6,8,8,25.0
4069,Keith Hancock,Clay,2,3,5,19,40.0
4070,Keith Hancock,Grass,4,10,14,19,28.57
4071,Keith Richardson,Carpet,1,8,9,61,11.11
4072,Keith Richardson,Clay,12,21,33,61,36.36
4073,Keith Richardson,Hard,5,14,19,61,26.32
4074,Keith Wooldridge,Clay,2,4,6,6,33.33
4075,Kelly Evernden,Carpet,19,27,46,284,41.3
4076,Kelly Evernden,Clay,9,12,21,284,42.86
4077,Kelly Evernden,Grass,38,27,65,284,58.46
4078,Kelly Evernden,Hard,71,81,152,284,46.71
4079,Kelly Jones,Carpet,5,17,22,131,22.73
4080,Kelly Jones,Grass,4,9,13,131,30.77
4081,Kelly Jones,Hard,40,56,96,131,41.67
4082,Kelvin Belcher,Carpet,1,1,2,13,50.0
4083,Kelvin Belcher,Grass,1,2,3,13,33.33
4084,Kelvin Belcher,Hard,2,6,8,13,25.0
4085,Kelvin Ng,Hard,3,4,7,7,42.86
4086,Ken Barton,Hard,1,1,2,2,50.0
4087,Ken Binns,Clay,3,3,6,6,50.0
4088,Ken Flach,Carpet,5,15,20,126,25.0
4089,Ken Flach,Grass,17,17,34,126,50.0
4090,Ken Flach,Hard,30,42,72,126,41.67
4091,Ken Fletcher,Clay,2,1,3,12,66.67
4092,Ken Fletcher,Grass,5,4,9,12,55.56
4093,Ken Rosewall,Carpet,99,50,149,647,66.44
4094,Ken Rosewall,Clay,110,27,137,647,80.29
4095,Ken Rosewall,Grass,135,36,171,647,78.95
4096,Ken Rosewall,Hard,139,51,190,647,73.16
4097,Ken Stuart,Grass,2,5,7,14,28.57
4098,Ken Stuart,Hard,1,6,7,14,14.29
4099,Kenichi Hirai,Clay,2,15,17,37,11.76
4100,Kenichi Hirai,Grass,1,8,9,37,11.11
4101,Kenichi Hirai,Hard,3,8,11,37,27.27
4102,Kenneth Andersson,Clay,1,3,4,4,25.0
4103,Kenneth Carlsen,Carpet,60,54,114,559,52.63
4104,Kenneth Carlsen,Clay,16,39,55,559,29.09
4105,Kenneth Carlsen,Grass,31,37,68,559,45.59
4106,Kenneth Carlsen,Hard,163,159,322,559,50.62
4107,Kenneth Dowuona,Hard,1,1,2,2,50.0
4108,Kenneth McMillan,Hard,1,4,5,5,20.0
4109,Kenneth Reid,Grass,2,5,7,7,28.57
4110,Kenneth Thome Bolanos,Clay,1,1,2,2,50.0
4111,Kenneth Tsui,Hard,1,1,2,2,50.0
4112,Kenny De Schepper,Clay,6,20,26,88,23.08
4113,Kenny De Schepper,Grass,9,12,21,88,42.86
4114,Kenny De Schepper,Hard,12,29,41,88,29.27
4115,Kenny Thorne,Carpet,5,5,10,50,50.0
4116,Kenny Thorne,Grass,1,7,8,50,12.5
4117,Kenny Thorne,Hard,8,24,32,50,25.0
4118,Kent Carlsson,Clay,153,52,205,218,74.63
4119,Kent Carlsson,Hard,7,6,13,218,53.85
4120,Kent Kinnear,Carpet,2,3,5,31,40.0
4121,Kent Kinnear,Grass,2,3,5,31,40.0
4122,Kent Kinnear,Hard,5,16,21,31,23.81
4123,Kepler Orellana,Clay,2,4,6,12,33.33
4124,Kepler Orellana,Hard,4,2,6,12,66.67
4125,Kevin Anderson,Clay,57,51,108,580,52.78
4126,Kevin Anderson,Grass,39,27,66,580,59.09
4127,Kevin Anderson,Hard,248,158,406,580,61.08
4128,Kevin Curren,Carpet,115,76,191,580,60.21
4129,Kevin Curren,Clay,9,18,27,580,33.33
4130,Kevin Curren,Grass,71,36,107,580,66.36
4131,Kevin Curren,Hard,145,110,255,580,56.86
4132,Kevin Kerns,Clay,1,1,2,2,50.0
4133,Kevin Kim,Carpet,1,3,4,141,25.0
4134,Kevin Kim,Clay,3,12,15,141,20.0
4135,Kevin Kim,Grass,4,14,18,141,22.22
4136,Kevin Kim,Hard,36,68,104,141,34.62
4137,Kevin King,Hard,1,5,6,6,16.67
4138,Kevin Krawietz,Grass,1,1,2,2,50.0
4139,Kevin Menton,Grass,1,2,3,6,33.33
4140,Kevin Menton,Hard,1,2,3,6,33.33
4141,Kevin Moir,Hard,3,9,12,12,25.0
4142,Kevin Sorensen,Carpet,1,1,2,6,50.0
4143,Kevin Sorensen,Hard,2,2,4,6,50.0
4144,Kevin Ullyett,Carpet,2,4,6,55,33.33
4145,Kevin Ullyett,Grass,6,6,12,55,50.0
4146,Kevin Ullyett,Hard,13,24,37,55,35.14
4147,Khaled Al Foudari,Hard,3,7,10,10,30.0
4148,Khaled Baligh,Hard,1,1,2,2,50.0
4149,Khaled El Salawy,Clay,6,3,9,9,66.67
4150,Khalid Al Nabhani,Hard,1,5,6,6,16.67
4151,Khalid Outaleb,Clay,7,2,9,12,77.78
4152,Khalid Outaleb,Hard,2,1,3,12,66.67
4153,Khoder Issa,Clay,1,3,4,4,25.0
4154,Kim Huat Khoo,Hard,1,2,3,3,33.33
4155,Kim Tiilikainen,Carpet,2,1,3,18,66.67
4156,Kim Tiilikainen,Clay,6,4,10,18,60.0
4157,Kim Tiilikainen,Hard,1,4,5,18,20.0
4158,Kim Warwick,Carpet,51,55,106,536,48.11
4159,Kim Warwick,Clay,83,77,160,536,51.88
4160,Kim Warwick,Grass,84,64,148,536,56.76
4161,Kim Warwick,Hard,56,66,122,536,45.9
4162,Kimmer Coppejans,Clay,3,8,11,11,27.27
4163,Kimmo Alkio,Clay,1,3,4,4,25.0
4164,Kittipong Wachiramanowong,Clay,1,1,2,30,50.0
4165,Kittipong Wachiramanowong,Hard,12,16,28,30,42.86
4166,Kiyoshi Tanabe,Grass,3,4,7,11,42.86
4167,Kiyoshi Tanabe,Hard,1,3,4,11,25.0
4168,Kiyoski Tanabe,Grass,2,3,5,9,40.0
4169,Kiyoski Tanabe,Hard,2,2,4,9,50.0
4170,Kj Hippensteel,Hard,1,3,4,4,25.0
4171,Kjell Johansson,Carpet,14,22,36,267,38.89
4172,Kjell Johansson,Clay,87,91,178,267,48.88
4173,Kjell Johansson,Grass,2,7,9,267,22.22
4174,Kjell Johansson,Hard,19,25,44,267,43.18
4175,Klaus Eberhard,Clay,44,50,94,123,46.81
4176,Klaus Eberhard,Grass,1,2,3,123,33.33
4177,Klaus Eberhard,Hard,8,18,26,123,30.77
4178,Koji Watanabe,Clay,4,6,10,23,40.0
4179,Koji Watanabe,Grass,2,9,11,23,18.18
4180,Koji Watanabe,Hard,1,1,2,23,50.0
4181,Kojo Atiso,Hard,5,4,9,9,55.56
4182,Konstantin Don Gruber,Hard,1,1,2,2,50.0
4183,Konstantin Kravchuk,Carpet,1,1,2,38,50.0
4184,Konstantin Kravchuk,Clay,2,2,4,38,50.0
4185,Konstantin Kravchuk,Grass,1,4,5,38,20.0
4186,Konstantin Kravchuk,Hard,6,21,27,38,22.22
4187,Konstantin Pugaev,Carpet,3,2,5,5,60.0
4188,Konstantin Pugayev,Carpet,3,1,4,4,75.0
4189,Konstantinos Economidis,Carpet,2,3,5,41,40.0
4190,Konstantinos Economidis,Clay,16,6,22,41,72.73
4191,Konstantinos Economidis,Hard,4,10,14,41,28.57
4192,Konstantinos Effraimoglou,Clay,4,9,13,15,30.77
4193,Konstantinos Effraimoglou,Hard,1,1,2,15,50.0
4194,Kornel Bardoczky,Clay,8,8,16,25,50.0
4195,Kornel Bardoczky,Hard,4,5,9,25,44.44
4196,Kossi Loglo,Hard,1,1,2,2,50.0
4197,Kotaro Miyachi,Hard,4,3,7,7,57.14
4198,Krassimir Lazarov,Clay,9,9,18,22,50.0
4199,Krassimir Lazarov,Hard,1,3,4,22,25.0
4200,Kris Goossens,Clay,10,22,32,32,31.25
4201,Kristian Capalik,Grass,2,2,4,7,50.0
4202,Kristian Capalik,Hard,1,2,3,7,33.33
4203,Kristian Mitrovski,Clay,1,1,2,2,50.0
4204,Kristian Pless,Carpet,8,7,15,141,53.33
4205,Kristian Pless,Clay,9,17,26,141,34.62
4206,Kristian Pless,Grass,4,12,16,141,25.0
4207,Kristian Pless,Hard,34,50,84,141,40.48
4208,Kristof Vliegen,Carpet,5,6,11,212,45.45
4209,Kristof Vliegen,Clay,36,48,84,212,42.86
4210,Kristof Vliegen,Grass,10,17,27,212,37.04
4211,Kristof Vliegen,Hard,38,52,90,212,42.22
4212,Krystian Pfeiffer,Clay,4,3,7,7,57.14
4213,Kuan Yi Lee,Hard,2,1,3,3,66.67
4214,Kunio Tsukamoto,Clay,1,1,2,2,50.0
4215,Kush Bhardwaj,Clay,2,3,5,5,40.0
4216,Kyle Edmund,Clay,26,27,53,234,49.06
4217,Kyle Edmund,Grass,12,19,31,234,38.71
4218,Kyle Edmund,Hard,80,70,150,234,53.33
4219,Kyu Tae Im,Hard,5,3,8,8,62.5
4220,L B Taylor,Grass,1,1,2,2,50.0
4221,L Maeso,Clay,1,1,2,2,50.0
4222,Lado Chikhladze,Carpet,3,2,5,17,60.0
4223,Lado Chikhladze,Clay,2,6,8,17,25.0
4224,Lado Chikhladze,Hard,1,3,4,17,25.0
4225,Lajos Levai,Hard,1,1,2,2,50.0
4226,Lamine Ouahab,Clay,17,14,31,39,54.84
4227,Lamine Ouahab,Hard,3,5,8,39,37.5
4228,Lan Bale,Hard,2,3,5,5,40.0
4229,Larry Gottfried,Clay,4,9,13,16,30.77
4230,Larry Gottfried,Hard,1,2,3,16,33.33
4231,Larry Loeb,Hard,1,1,2,2,50.0
4232,Larry Nagler,Hard,1,4,5,5,20.0
4233,Larry Parker,Grass,1,3,4,4,25.0
4234,Larry Scott,Grass,1,4,5,5,20.0
4235,Larry Stefanki,Carpet,7,18,25,140,28.0
4236,Larry Stefanki,Clay,6,10,16,140,37.5
4237,Larry Stefanki,Grass,6,17,23,140,26.09
4238,Larry Stefanki,Hard,34,42,76,140,44.74
4239,Larry Turville,Clay,2,7,9,19,22.22
4240,Larry Turville,Grass,4,6,10,19,40.0
4241,Lars Anders Wahlgren,Carpet,1,6,7,72,14.29
4242,Lars Anders Wahlgren,Clay,4,16,20,72,20.0
4243,Lars Anders Wahlgren,Hard,18,27,45,72,40.0
4244,Lars Burgsmuller,Carpet,11,11,22,242,50.0
4245,Lars Burgsmuller,Clay,20,44,64,242,31.25
4246,Lars Burgsmuller,Grass,8,18,26,242,30.77
4247,Lars Burgsmuller,Hard,51,79,130,242,39.23
4248,Lars Elvstrom,Carpet,7,5,12,33,58.33
4249,Lars Elvstrom,Clay,7,9,16,33,43.75
4250,Lars Elvstrom,Hard,1,4,5,33,20.0
4251,Lars Jonsson,Carpet,7,13,20,218,35.0
4252,Lars Jonsson,Clay,48,69,117,218,41.03
4253,Lars Jonsson,Grass,2,7,9,218,22.22
4254,Lars Jonsson,Hard,29,43,72,218,40.28
4255,Lars Koslowski,Clay,8,15,23,41,34.78
4256,Lars Koslowski,Hard,9,9,18,41,50.0
4257,Lars Olander,Clay,1,2,3,8,33.33
4258,Lars Olander,Hard,2,3,5,8,40.0
4259,Lars Rehmann,Carpet,7,10,17,37,41.18
4260,Lars Rehmann,Clay,1,3,4,37,25.0
4261,Lars Rehmann,Hard,8,8,16,37,50.0
4262,Laslo Djere,Clay,45,26,71,112,63.38
4263,Laslo Djere,Grass,1,4,5,112,20.0
4264,Laslo Djere,Hard,7,29,36,112,19.44
4265,Laszlo Markovits,Clay,1,3,4,4,25.0
4266,Laurence Tieleman,Carpet,1,3,4,102,25.0
4267,Laurence Tieleman,Clay,1,9,10,102,10.0
4268,Laurence Tieleman,Grass,20,18,38,102,52.63
4269,Laurence Tieleman,Hard,19,31,50,102,38.0
4270,Laurent Bram,Clay,2,3,5,5,40.0
4271,Laurent Prades,Carpet,1,1,2,13,50.0
4272,Laurent Prades,Clay,1,3,4,13,25.0
4273,Laurent Prades,Hard,2,5,7,13,28.57
4274,Laurent Recouderc,Clay,2,5,7,15,28.57
4275,Laurent Recouderc,Hard,1,7,8,15,12.5
4276,Laurie Warder,Grass,3,5,8,17,37.5
4277,Laurie Warder,Hard,2,7,9,17,22.22
4278,Laurynas Grigelis,Clay,3,2,5,26,60.0
4279,Laurynas Grigelis,Hard,5,16,21,26,23.81
4280,Lawrence Hall,Grass,2,3,5,5,40.0
4281,Lawson Duncan,Carpet,3,6,9,214,33.33
4282,Lawson Duncan,Clay,93,79,172,214,54.07
4283,Lawson Duncan,Hard,9,24,33,214,27.27
4284,Lazar Magdincev,Clay,5,7,12,17,41.67
4285,Lazar Magdincev,Hard,2,3,5,17,40.0
4286,Lazaro Navarro Batles,Hard,11,4,15,15,73.33
4287,Leander Paes,Carpet,11,10,21,198,52.38
4288,Leander Paes,Clay,6,8,14,198,42.86
4289,Leander Paes,Grass,46,24,70,198,65.71
4290,Leander Paes,Hard,38,55,93,198,40.86
4291,Lech Sidor,Clay,2,1,3,3,66.67
4292,Lee Childs,Grass,1,7,8,10,12.5
4293,Lee Childs,Hard,1,1,2,10,50.0
4294,Leeh Bienkowski,Clay,2,5,7,9,28.57
4295,Leeh Bienkowski,Hard,1,1,2,9,50.0
4296,Lefteris Alexiou,Hard,1,2,3,3,33.33
4297,Leif Johansson,Clay,11,12,23,35,47.83
4298,Leif Johansson,Grass,1,2,3,35,33.33
4299,Leif Johansson,Hard,3,6,9,35,33.33
4300,Leif Shiras,Carpet,19,19,38,174,50.0
4301,Leif Shiras,Clay,3,8,11,174,27.27
4302,Leif Shiras,Grass,27,27,54,174,50.0
4303,Leif Shiras,Hard,22,49,71,174,30.99
4304,Lenny Schloss,Clay,3,7,10,28,30.0
4305,Lenny Schloss,Grass,1,4,5,28,20.0
4306,Lenny Schloss,Hard,1,12,13,28,7.69
4307,Leo Palin,Carpet,7,10,17,104,41.18
4308,Leo Palin,Clay,16,27,43,104,37.21
4309,Leo Palin,Grass,1,4,5,104,20.0
4310,Leo Palin,Hard,12,27,39,104,30.77
4311,Leon Naude,Hard,1,1,2,2,50.0
4312,Leonardo Lavalle,Carpet,12,15,27,200,44.44
4313,Leonardo Lavalle,Clay,35,37,72,200,48.61
4314,Leonardo Lavalle,Grass,2,11,13,200,15.38
4315,Leonardo Lavalle,Hard,36,52,88,200,40.91
4316,Leonardo Mayer,Clay,93,84,177,377,52.54
4317,Leonardo Mayer,Grass,16,19,35,377,45.71
4318,Leonardo Mayer,Hard,71,94,165,377,43.03
4319,Leonardo Tavares,Carpet,1,2,3,17,33.33
4320,Leonardo Tavares,Clay,4,5,9,17,44.44
4321,Leonardo Tavares,Hard,1,4,5,17,20.0
4322,Leos Friedl,Clay,2,1,3,7,66.67
4323,Leos Friedl,Hard,1,3,4,7,25.0
4324,Lester Sack,Clay,4,3,7,7,57.14
4325,Lew Hoad,Clay,9,11,20,45,45.0
4326,Lew Hoad,Grass,12,9,21,45,57.14
4327,Lew Hoad,Hard,2,2,4,45,50.0
4328,Lewis Sylvester,Grass,3,1,4,9,75.0
4329,Lewis Sylvester,Hard,2,3,5,9,40.0
4330,Liam Broady,Grass,1,6,7,12,14.29
4331,Liam Broady,Hard,3,2,5,12,60.0
4332,Liang Chi Huang,Hard,5,1,6,6,83.33
4333,Libor Nemecek,Clay,3,9,12,31,25.0
4334,Libor Nemecek,Hard,8,11,19,31,42.11
4335,Libor Pimek,Carpet,17,23,40,245,42.5
4336,Libor Pimek,Clay,74,63,137,245,54.01
4337,Libor Pimek,Hard,35,33,68,245,51.47
4338,Lionel Barthez,Carpet,2,1,3,12,66.67
4339,Lionel Barthez,Hard,2,7,9,12,22.22
4340,Lionel Kemajou,Clay,1,1,2,2,50.0
4341,Lionel Roux,Carpet,16,25,41,187,39.02
4342,Lionel Roux,Clay,7,18,25,187,28.0
4343,Lionel Roux,Hard,53,68,121,187,43.8
4344,Lior Mor,Clay,1,1,2,2,50.0
4345,Lito Alvarez,Carpet,3,10,13,162,23.08
4346,Lito Alvarez,Clay,36,83,119,162,30.25
4347,Lito Alvarez,Grass,2,8,10,162,20.0
4348,Lito Alvarez,Hard,4,16,20,162,20.0
4349,Lleyton Hewitt,Carpet,19,7,26,882,73.08
4350,Lleyton Hewitt,Clay,98,56,154,882,63.64
4351,Lleyton Hewitt,Grass,129,42,171,882,75.44
4352,Lleyton Hewitt,Hard,373,158,531,882,70.24
4353,Lloyd Bourne,Carpet,8,15,23,159,34.78
4354,Lloyd Bourne,Clay,10,12,22,159,45.45
4355,Lloyd Bourne,Grass,26,25,51,159,50.98
4356,Lloyd Bourne,Hard,24,39,63,159,38.1
4357,Lloyd Harris,Clay,2,6,8,65,25.0
4358,Lloyd Harris,Hard,30,27,57,65,52.63
4359,Loic Courteau,Clay,14,19,33,53,42.42
4360,Loic Courteau,Grass,3,5,8,53,37.5
4361,Loic Courteau,Hard,4,8,12,53,33.33
4362,Lorenzo Fargas,Clay,1,13,14,14,7.14
4363,Lorenzo Giustino,Clay,1,4,5,5,20.0
4364,Lorenzo Manta,Carpet,1,6,7,34,14.29
4365,Lorenzo Manta,Grass,3,6,9,34,33.33
4366,Lorenzo Manta,Hard,7,11,18,34,38.89
4367,Lorenzo Musetti,Clay,5,2,7,7,71.43
4368,Lorenzo Sonego,Clay,21,23,44,87,47.73
4369,Lorenzo Sonego,Grass,5,3,8,87,62.5
4370,Lorenzo Sonego,Hard,14,21,35,87,40.0
4371,Lothar Pawlik,Clay,1,2,3,3,33.33
4372,Louis Gloria,Carpet,1,2,3,24,33.33
4373,Louis Gloria,Clay,1,2,3,24,33.33
4374,Louis Gloria,Grass,1,6,7,24,14.29
4375,Louis Gloria,Hard,2,9,11,24,18.18
4376,Louis Pretorius,Grass,1,1,2,2,50.0
4377,Louis Wessels,Clay,1,1,2,2,50.0
4378,Louk Sanders,Carpet,6,17,23,142,26.09
4379,Louk Sanders,Clay,43,49,92,142,46.74
4380,Louk Sanders,Hard,10,17,27,142,37.04
4381,Louk Sorensen,Clay,1,1,2,9,50.0
4382,Louk Sorensen,Hard,2,5,7,9,28.57
4383,Lovro Zovko,Clay,2,9,11,17,18.18
4384,Lovro Zovko,Hard,2,4,6,17,33.33
4385,Luca Bottazzi,Clay,5,12,17,17,29.41
4386,Luca Vanni,Clay,4,8,12,22,33.33
4387,Luca Vanni,Hard,1,9,10,22,10.0
4388,Lucas Arnold Ker,Clay,19,22,41,51,46.34
4389,Lucas Arnold Ker,Hard,3,7,10,51,30.0
4390,Lucas Gomez,Clay,2,4,6,16,33.33
4391,Lucas Gomez,Hard,1,9,10,16,10.0
4392,Lucas Pouille,Clay,35,28,63,241,55.56
4393,Lucas Pouille,Grass,18,13,31,241,58.06
4394,Lucas Pouille,Hard,79,68,147,241,53.74
4395,Luciano Ramazzini,Hard,1,1,2,2,50.0
4396,Lui Pang,Hard,3,3,6,6,50.0
4397,Luis Adrian Morejon,Clay,20,28,48,64,41.67
4398,Luis Adrian Morejon,Hard,6,10,16,64,37.5
4399,Luis Alberto Ayala,Clay,1,1,2,2,50.0
4400,Luis Arturo Gonzalez,Clay,2,4,6,6,33.33
4401,Luis Augusto Garcia,Clay,2,2,4,4,50.0
4402,Luis Ayala,Clay,9,10,19,33,47.37
4403,Luis Ayala,Grass,4,7,11,33,36.36
4404,Luis Ayala,Hard,2,1,3,33,66.67
4405,Luis Baraldi,Clay,2,5,7,7,28.57
4406,Luis Borfiga,Clay,4,12,16,16,25.0
4407,Luis Bruguera,Clay,3,12,15,15,20.0
4408,Luis David Martinez,Clay,1,3,4,16,25.0
4409,Luis David Martinez,Hard,6,6,12,16,50.0
4410,Luis Delgado,Clay,1,2,3,3,33.33
4411,Luis Felipe Tavares,Carpet,1,4,5,19,20.0
4412,Luis Felipe Tavares,Clay,3,7,10,19,30.0
4413,Luis Felipe Tavares,Hard,2,2,4,19,50.0
4414,Luis Haddock,Hard,1,1,2,2,50.0
4415,Luis Herrera,Carpet,2,6,8,136,25.0
4416,Luis Herrera,Clay,11,19,30,136,36.67
4417,Luis Herrera,Grass,12,13,25,136,48.0
4418,Luis Herrera,Hard,28,45,73,136,38.36
4419,Luis Horna,Carpet,1,4,5,282,20.0
4420,Luis Horna,Clay,104,86,190,282,54.74
4421,Luis Horna,Hard,36,51,87,282,41.38
4422,Luis Lobo,Clay,2,3,5,5,40.0
4423,Luis Manuel Flores,Hard,1,1,2,2,50.0
4424,Luis Patino,Hard,3,2,5,5,60.0
4425,Luis Perez Chete,Hard,6,4,10,10,60.0
4426,Luiz Mattar,Carpet,23,19,42,370,54.76
4427,Luiz Mattar,Clay,81,83,164,370,49.39
4428,Luiz Mattar,Grass,1,6,7,370,14.29
4429,Luiz Mattar,Hard,87,70,157,370,55.41
4430,Luka Gregorc,Carpet,1,1,2,18,50.0
4431,Luka Gregorc,Hard,8,8,16,18,50.0
4432,Lukas Dlouhy,Carpet,3,6,9,77,33.33
4433,Lukas Dlouhy,Clay,14,26,40,77,35.0
4434,Lukas Dlouhy,Grass,2,5,7,77,28.57
4435,Lukas Dlouhy,Hard,4,17,21,77,19.05
4436,Lukas Lacko,Clay,5,20,25,243,20.0
4437,Lukas Lacko,Grass,18,25,43,243,41.86
4438,Lukas Lacko,Hard,73,102,175,243,41.71
4439,Lukas Mugevicius,Clay,1,3,4,10,25.0
4440,Lukas Mugevicius,Hard,2,4,6,10,33.33
4441,Lukas Rosol,Clay,53,48,101,281,52.48
4442,Lukas Rosol,Grass,8,12,20,281,40.0
4443,Lukas Rosol,Hard,63,97,160,281,39.38
4444,Lukasz Kubot,Carpet,2,1,3,229,66.67
4445,Lukasz Kubot,Clay,46,51,97,229,47.42
4446,Lukasz Kubot,Grass,13,12,25,229,52.0
4447,Lukasz Kubot,Hard,38,66,104,229,36.54
4448,Luke Jensen,Carpet,1,5,6,55,16.67
4449,Luke Jensen,Clay,4,12,16,55,25.0
4450,Luke Jensen,Grass,1,3,4,55,25.0
4451,Luke Jensen,Hard,6,23,29,55,20.69
4452,Luke Milligan,Grass,3,5,8,11,37.5
4453,Luke Milligan,Hard,2,1,3,11,66.67
4454,Luke Saville,Grass,2,4,6,6,33.33
4455,Luke Smith,Hard,2,5,7,7,28.57
4456,M Abid Ali Khan Akbar,Hard,1,1,2,2,50.0
4457,M Borgener,Hard,1,1,2,2,50.0
4458,M Laimina,Clay,1,1,2,2,50.0
4459,M Lorenzo,Grass,1,1,2,2,50.0
4460,Ma Ilahi,Grass,1,1,2,2,50.0
4461,Mackenzie McDonald,Clay,3,7,10,67,30.0
4462,Mackenzie McDonald,Grass,5,3,8,67,62.5
4463,Mackenzie McDonald,Hard,19,30,49,67,38.78
4464,Magnus Gustafsson,Carpet,96,55,151,676,63.58
4465,Magnus Gustafsson,Clay,213,115,328,676,64.94
4466,Magnus Gustafsson,Grass,18,18,36,676,50.0
4467,Magnus Gustafsson,Hard,88,73,161,676,54.66
4468,Magnus Larsson,Carpet,64,36,100,542,64.0
4469,Magnus Larsson,Clay,110,83,193,542,56.99
4470,Magnus Larsson,Grass,24,19,43,542,55.81
4471,Magnus Larsson,Hard,115,91,206,542,55.83
4472,Magnus Nilsson,Clay,1,1,2,2,50.0
4473,Magnus Norman,Carpet,15,14,29,423,51.72
4474,Magnus Norman,Clay,109,71,180,423,60.56
4475,Magnus Norman,Grass,7,8,15,423,46.67
4476,Magnus Norman,Hard,115,84,199,423,57.79
4477,Magnus Tideman,Clay,10,25,35,46,28.57
4478,Magnus Tideman,Hard,4,7,11,46,36.36
4479,Mahader Hassan,Grass,1,2,3,3,33.33
4480,Mahesh Bhupathi,Clay,1,3,4,37,25.0
4481,Mahesh Bhupathi,Grass,6,10,16,37,37.5
4482,Mahesh Bhupathi,Hard,3,14,17,37,17.65
4483,Mahtabur Rahman,Hard,1,3,4,4,25.0
4484,Mait Kunnap,Carpet,2,3,5,8,40.0
4485,Mait Kunnap,Hard,1,2,3,8,33.33
4486,Mal Anderson,Clay,5,9,14,109,35.71
4487,Mal Anderson,Grass,35,24,59,109,59.32
4488,Mal Anderson,Hard,23,13,36,109,63.89
4489,Malcolm Allen,Hard,1,4,5,5,20.0
4490,Malek Jaziri,Carpet,1,1,2,232,50.0
4491,Malek Jaziri,Clay,23,31,54,232,42.59
4492,Malek Jaziri,Grass,8,19,27,232,29.63
4493,Malek Jaziri,Hard,64,85,149,232,42.95
4494,Malivai Washington,Carpet,40,37,77,436,51.95
4495,Malivai Washington,Clay,43,33,76,436,56.58
4496,Malivai Washington,Grass,26,21,47,436,55.32
4497,Malivai Washington,Hard,142,94,236,436,60.17
4498,Mansour Bahrami,Carpet,6,7,13,84,46.15
4499,Mansour Bahrami,Clay,20,29,49,84,40.82
4500,Mansour Bahrami,Hard,6,16,22,84,27.27
4501,Manuel De Sousa,Clay,1,3,4,4,25.0
4502,Manuel Diaz,Hard,2,3,5,5,40.0
4503,Manuel Orantes,Carpet,38,39,77,956,49.35
4504,Manuel Orantes,Clay,560,170,730,956,76.71
4505,Manuel Orantes,Grass,31,23,54,956,57.41
4506,Manuel Orantes,Hard,54,41,95,956,56.84
4507,Manuel Sanchez,Clay,3,5,8,11,37.5
4508,Manuel Sanchez,Hard,2,1,3,11,66.67
4509,Manuel Santana,Carpet,9,7,16,128,56.25
4510,Manuel Santana,Clay,60,22,82,128,73.17
4511,Manuel Santana,Grass,9,5,14,128,64.29
4512,Manuel Santana,Hard,9,7,16,128,56.25
4513,Manuel Tejada,Clay,1,7,8,10,12.5
4514,Manuel Tejada,Hard,1,1,2,10,50.0
4515,Manuel Tolentino,Clay,3,1,4,4,75.0
4516,Manuel Valleramos,Hard,1,1,2,2,50.0
4517,Mao Xin Gong,Hard,2,6,8,8,25.0
4518,Marat Safin,Carpet,61,26,87,693,70.11
4519,Marat Safin,Clay,121,82,203,693,59.61
4520,Marat Safin,Grass,26,19,45,693,57.78
4521,Marat Safin,Hard,216,142,358,693,60.34
4522,Marc Abdulnour,Clay,1,1,2,7,50.0
4523,Marc Abdulnour,Hard,2,3,5,7,40.0
4524,Marc Andrea Huesler,Clay,4,3,7,12,57.14
4525,Marc Andrea Huesler,Hard,2,3,5,12,40.0
4526,Marc Flur,Carpet,2,7,9,101,22.22
4527,Marc Flur,Clay,4,8,12,101,33.33
4528,Marc Flur,Grass,11,16,27,101,40.74
4529,Marc Flur,Hard,21,32,53,101,39.62
4530,Marc Gicquel,Carpet,12,6,18,205,66.67
4531,Marc Gicquel,Clay,26,33,59,205,44.07
4532,Marc Gicquel,Grass,11,15,26,205,42.31
4533,Marc Gicquel,Hard,43,59,102,205,42.16
4534,Marc Kevin Goellner,Carpet,19,30,49,355,38.78
4535,Marc Kevin Goellner,Clay,87,83,170,355,51.18
4536,Marc Kevin Goellner,Grass,17,20,37,355,45.95
4537,Marc Kevin Goellner,Hard,37,62,99,355,37.37
4538,Marc Lopez,Clay,20,27,47,54,42.55
4539,Marc Lopez,Grass,1,2,3,54,33.33
4540,Marc Lopez,Hard,2,2,4,54,50.0
4541,Marc Polmans,Clay,1,2,3,14,33.33
4542,Marc Polmans,Hard,2,9,11,14,18.18
4543,Marc Rosset,Carpet,126,72,198,789,63.64
4544,Marc Rosset,Clay,118,116,234,789,50.43
4545,Marc Rosset,Grass,28,31,59,789,47.46
4546,Marc Rosset,Hard,162,136,298,789,54.36
4547,Marcel Felder,Clay,15,12,27,33,55.56
4548,Marcel Felder,Hard,4,2,6,33,66.67
4549,Marcel Freeman,Carpet,5,11,16,140,31.25
4550,Marcel Freeman,Clay,13,21,34,140,38.24
4551,Marcel Freeman,Grass,7,13,20,140,35.0
4552,Marcel Freeman,Hard,28,42,70,140,40.0
4553,Marcel Granollers,Clay,103,111,214,453,48.13
4554,Marcel Granollers,Grass,17,21,38,453,44.74
4555,Marcel Granollers,Hard,83,118,201,453,41.29
4556,Marcello Craca,Clay,10,18,28,33,35.71
4557,Marcello Craca,Hard,1,4,5,33,20.0
4558,Marcello Lara,Carpet,2,10,12,172,16.67
4559,Marcello Lara,Clay,43,57,100,172,43.0
4560,Marcello Lara,Grass,6,16,22,172,27.27
4561,Marcello Lara,Hard,14,24,38,172,36.84
4562,Marcelo Arevalo,Clay,3,10,13,38,23.08
4563,Marcelo Arevalo,Hard,18,7,25,38,72.0
4564,Marcelo Charpentier,Clay,6,19,25,31,24.0
4565,Marcelo Charpentier,Hard,2,4,6,31,33.33
4566,Marcelo Demoliner,Hard,1,1,2,2,50.0
4567,Marcelo Filippini,Carpet,4,11,15,498,26.67
4568,Marcelo Filippini,Clay,218,180,398,498,54.77
4569,Marcelo Filippini,Hard,27,58,85,498,31.76
4570,Marcelo Hennemann,Carpet,1,1,2,16,50.0
4571,Marcelo Hennemann,Clay,3,5,8,16,37.5
4572,Marcelo Hennemann,Hard,2,4,6,16,33.33
4573,Marcelo Ingaramo,Clay,30,45,75,82,40.0
4574,Marcelo Ingaramo,Hard,3,4,7,82,42.86
4575,Marcelo Rios,Carpet,31,19,50,589,62.0
4576,Marcelo Rios,Clay,181,82,263,589,68.82
4577,Marcelo Rios,Grass,6,6,12,589,50.0
4578,Marcelo Rios,Hard,176,88,264,589,66.67
4579,Marcelo Saliola,Carpet,3,2,5,5,60.0
4580,Marcelo Tomas Barrios Vera,Clay,1,2,3,5,33.33
4581,Marcelo Tomas Barrios Vera,Hard,1,1,2,5,50.0
4582,Marcin Gawron,Hard,1,1,2,2,50.0
4583,Marcin Matkowski,Clay,3,3,6,6,50.0
4584,Marcio Carlsson,Clay,5,8,13,13,38.46
4585,Marco Alciati,Clay,3,6,9,9,33.33
4586,Marco Armellini,Clay,4,3,7,7,57.14
4587,Marco Cecchinato,Clay,38,46,84,137,45.24
4588,Marco Cecchinato,Grass,2,6,8,137,25.0
4589,Marco Cecchinato,Hard,10,35,45,137,22.22
4590,Marco Chiudinelli,Carpet,3,2,5,149,60.0
4591,Marco Chiudinelli,Clay,7,20,27,149,25.93
4592,Marco Chiudinelli,Grass,6,9,15,149,40.0
4593,Marco Chiudinelli,Hard,36,66,102,149,35.29
4594,Marco Consolini,Clay,1,4,5,5,20.0
4595,Marco Meneschincheri,Clay,1,11,12,14,8.33
4596,Marco Meneschincheri,Hard,1,1,2,14,50.0
4597,Marco Osorio,Hard,5,3,8,8,62.5
4598,Marco Trungelliti,Clay,11,11,22,27,50.0
4599,Marco Trungelliti,Hard,1,4,5,27,20.0
4600,Marcos Aurelio Gorriz,Carpet,3,5,8,116,37.5
4601,Marcos Aurelio Gorriz,Clay,30,57,87,116,34.48
4602,Marcos Aurelio Gorriz,Grass,1,3,4,116,25.0
4603,Marcos Aurelio Gorriz,Hard,4,13,17,116,23.53
4604,Marcos Baghdatis,Carpet,13,2,15,624,86.67
4605,Marcos Baghdatis,Clay,38,50,88,624,43.18
4606,Marcos Baghdatis,Grass,55,40,95,624,57.89
4607,Marcos Baghdatis,Hard,244,182,426,624,57.28
4608,Marcos Daniel,Clay,22,37,59,90,37.29
4609,Marcos Daniel,Grass,1,6,7,90,14.29
4610,Marcos Daniel,Hard,1,23,24,90,4.17
4611,Marcos Giron,Clay,1,1,2,32,50.0
4612,Marcos Giron,Hard,13,17,30,32,43.33
4613,Marcos Hocevar,Carpet,1,9,10,188,10.0
4614,Marcos Hocevar,Clay,59,63,122,188,48.36
4615,Marcos Hocevar,Grass,12,11,23,188,52.17
4616,Marcos Hocevar,Hard,15,18,33,188,45.45
4617,Marcos Ondruska,Carpet,4,13,17,265,23.53
4618,Marcos Ondruska,Clay,27,33,60,265,45.0
4619,Marcos Ondruska,Grass,13,17,30,265,43.33
4620,Marcos Ondruska,Hard,74,84,158,265,46.84
4621,Marcus Daniell,Hard,1,1,2,2,50.0
4622,Marcus Hilpert,Hard,1,2,3,3,33.33
4623,Marcus Sarstrand,Clay,1,2,3,3,33.33
4624,Marcus Willis,Grass,1,1,2,2,50.0
4625,Mardy Fish,Carpet,4,7,11,526,36.36
4626,Mardy Fish,Clay,30,35,65,526,46.15
4627,Mardy Fish,Grass,46,26,72,526,63.89
4628,Mardy Fish,Hard,223,155,378,526,58.99
4629,Marian Laudin,Clay,1,2,3,3,33.33
4630,Marian Vajda,Carpet,8,24,32,272,25.0
4631,Marian Vajda,Clay,94,87,181,272,51.93
4632,Marian Vajda,Grass,1,3,4,272,25.0
4633,Marian Vajda,Hard,17,38,55,272,30.91
4634,Mariano Hood,Clay,4,7,11,11,36.36
4635,Mariano Puerta,Carpet,4,8,12,243,33.33
4636,Mariano Puerta,Clay,108,77,185,243,58.38
4637,Mariano Puerta,Hard,16,30,46,243,34.78
4638,Mariano Sanchez,Clay,2,1,3,3,66.67
4639,Mariano Zabaleta,Carpet,2,6,8,412,25.0
4640,Mariano Zabaleta,Clay,150,120,270,412,55.56
4641,Mariano Zabaleta,Hard,51,83,134,412,38.06
4642,Marin Cilic,Carpet,4,5,9,809,44.44
4643,Marin Cilic,Clay,125,77,202,809,61.88
4644,Marin Cilic,Grass,68,31,99,809,68.69
4645,Marin Cilic,Hard,323,176,499,809,64.73
4646,Marinko Matosevic,Clay,8,19,27,159,29.63
4647,Marinko Matosevic,Grass,8,12,20,159,40.0
4648,Marinko Matosevic,Hard,48,64,112,159,42.86
4649,Mario Ancic,Carpet,23,15,38,344,60.53
4650,Mario Ancic,Clay,35,26,61,344,57.38
4651,Mario Ancic,Grass,39,14,53,344,73.58
4652,Mario Ancic,Hard,111,81,192,344,57.81
4653,Mario Martinez,Carpet,3,5,8,166,37.5
4654,Mario Martinez,Clay,81,61,142,166,57.04
4655,Mario Martinez,Hard,5,11,16,166,31.25
4656,Mario Monroy,Clay,1,1,2,4,50.0
4657,Mario Monroy,Hard,1,1,2,4,50.0
4658,Mario Radic,Clay,2,4,6,6,33.33
4659,Mario Rincon,Clay,3,14,17,24,17.65
4660,Mario Rincon,Hard,1,6,7,24,14.29
4661,Mario Tabares,Clay,6,9,15,33,40.0
4662,Mario Tabares,Hard,10,8,18,33,55.56
4663,Mario Vilella Martinez,Hard,2,3,5,5,40.0
4664,Mario Visconti,Clay,2,6,8,8,25.0
4665,Marius Copil,Clay,10,27,37,149,27.03
4666,Marius Copil,Grass,6,9,15,149,40.0
4667,Marius Copil,Hard,46,51,97,149,47.42
4668,Mariusz Fyrstenberg,Carpet,1,1,2,14,50.0
4669,Mariusz Fyrstenberg,Clay,3,6,9,14,33.33
4670,Mariusz Fyrstenberg,Hard,1,2,3,14,33.33
4671,Mark Bailey,Carpet,3,3,6,30,50.0
4672,Mark Bailey,Clay,2,2,4,30,50.0
4673,Mark Bailey,Grass,1,1,2,30,50.0
4674,Mark Bailey,Hard,11,7,18,30,61.11
4675,Mark Buckley,Clay,5,16,21,23,23.81
4676,Mark Buckley,Hard,1,1,2,23,50.0
4677,Mark Cox,Carpet,109,73,182,587,59.89
4678,Mark Cox,Clay,77,60,137,587,56.2
4679,Mark Cox,Grass,64,40,104,587,61.54
4680,Mark Cox,Hard,93,71,164,587,56.71
4681,Mark Dickson,Carpet,31,30,61,246,50.82
4682,Mark Dickson,Clay,43,39,82,246,52.44
4683,Mark Dickson,Grass,11,8,19,246,57.89
4684,Mark Dickson,Hard,43,41,84,246,51.19
4685,Mark Draper,Grass,1,1,2,2,50.0
4686,Mark Edmondson,Carpet,35,42,77,504,45.45
4687,Mark Edmondson,Clay,65,82,147,504,44.22
4688,Mark Edmondson,Grass,109,62,171,504,63.74
4689,Mark Edmondson,Hard,51,58,109,504,46.79
4690,Mark Farrell,Carpet,2,4,6,57,33.33
4691,Mark Farrell,Clay,2,17,19,57,10.53
4692,Mark Farrell,Grass,11,14,25,57,44.0
4693,Mark Farrell,Hard,1,6,7,57,14.29
4694,Mark Gurr,Hard,1,3,4,4,25.0
4695,Mark Hilton,Grass,1,4,5,5,20.0
4696,Mark Kaplan,Clay,5,5,10,32,50.0
4697,Mark Kaplan,Grass,3,4,7,32,42.86
4698,Mark Kaplan,Hard,3,12,15,32,20.0
4699,Mark Keil,Carpet,1,1,2,12,50.0
4700,Mark Keil,Grass,2,3,5,12,40.0
4701,Mark Keil,Hard,1,4,5,12,20.0
4702,Mark Knowles,Carpet,5,4,9,123,55.56
4703,Mark Knowles,Clay,9,18,27,123,33.33
4704,Mark Knowles,Grass,8,9,17,123,47.06
4705,Mark Knowles,Hard,24,46,70,123,34.29
4706,Mark Koevermans,Carpet,5,12,17,156,29.41
4707,Mark Koevermans,Clay,46,46,92,156,50.0
4708,Mark Koevermans,Grass,3,3,6,156,50.0
4709,Mark Koevermans,Hard,18,23,41,156,43.9
4710,Mark Kratzmann,Carpet,7,11,18,156,38.89
4711,Mark Kratzmann,Clay,1,9,10,156,10.0
4712,Mark Kratzmann,Grass,25,24,49,156,51.02
4713,Mark Kratzmann,Hard,27,52,79,156,34.18
4714,Mark Lewis,Grass,1,1,2,9,50.0
4715,Mark Lewis,Hard,2,5,7,9,28.57
4716,Mark Lyndon,Grass,1,1,2,2,50.0
4717,Mark Markov,Clay,1,1,2,2,50.0
4718,Mark Merklein,Hard,10,15,25,25,40.0
4719,Mark Meyers,Clay,2,4,6,6,33.33
4720,Mark Nielsen,Carpet,3,5,8,38,37.5
4721,Mark Nielsen,Hard,15,15,30,38,50.0
4722,Mark Petchey,Carpet,4,9,13,109,30.77
4723,Mark Petchey,Clay,4,7,11,109,36.36
4724,Mark Petchey,Grass,17,28,45,109,37.78
4725,Mark Petchey,Hard,10,30,40,109,25.0
4726,Mark Philippoussis,Carpet,31,22,53,522,58.49
4727,Mark Philippoussis,Clay,52,41,93,522,55.91
4728,Mark Philippoussis,Grass,51,23,74,522,68.92
4729,Mark Philippoussis,Hard,181,121,302,522,59.93
4730,Mark Turpin,Clay,1,3,4,4,25.0
4731,Mark Vines,Carpet,1,4,5,24,20.0
4732,Mark Vines,Hard,7,12,19,24,36.84
4733,Mark Woodforde,Carpet,46,45,91,631,50.55
4734,Mark Woodforde,Clay,43,68,111,631,38.74
4735,Mark Woodforde,Grass,51,44,95,631,53.68
4736,Mark Woodforde,Hard,179,155,334,631,53.59
4737,Mark Wooldridge,Grass,2,3,5,13,40.0
4738,Mark Wooldridge,Hard,1,7,8,13,12.5
4739,Marko Ostoja,Carpet,8,13,21,228,38.1
4740,Marko Ostoja,Clay,56,77,133,228,42.11
4741,Marko Ostoja,Grass,3,4,7,228,42.86
4742,Marko Ostoja,Hard,21,46,67,228,31.34
4743,Marko Tkalec,Carpet,2,2,4,34,50.0
4744,Marko Tkalec,Clay,17,3,20,34,85.0
4745,Marko Tkalec,Hard,5,5,10,34,50.0
4746,Markus Eriksson,Clay,1,4,5,13,20.0
4747,Markus Eriksson,Hard,4,4,8,13,50.0
4748,Markus Gunthardt,Clay,2,9,11,11,18.18
4749,Markus Hantschk,Clay,16,20,36,67,44.44
4750,Markus Hantschk,Grass,1,3,4,67,25.0
4751,Markus Hantschk,Hard,9,18,27,67,33.33
4752,Markus Hipfl,Clay,56,54,110,143,50.91
4753,Markus Hipfl,Grass,1,6,7,143,14.29
4754,Markus Hipfl,Hard,8,18,26,143,30.77
4755,Markus Naewie,Carpet,2,4,6,57,33.33
4756,Markus Naewie,Clay,13,21,34,57,38.24
4757,Markus Naewie,Grass,1,3,4,57,25.0
4758,Markus Naewie,Hard,5,8,13,57,38.46
4759,Markus Rackl,Carpet,1,1,2,21,50.0
4760,Markus Rackl,Clay,7,12,19,21,36.84
4761,Markus Zillner,Clay,5,8,13,13,38.46
4762,Markus Zoecke,Carpet,13,22,35,170,37.14
4763,Markus Zoecke,Clay,4,14,18,170,22.22
4764,Markus Zoecke,Grass,5,11,16,170,31.25
4765,Markus Zoecke,Hard,45,56,101,170,44.55
4766,Marsel Ilhan,Carpet,1,1,2,90,50.0
4767,Marsel Ilhan,Clay,6,18,24,90,25.0
4768,Marsel Ilhan,Grass,4,8,12,90,33.33
4769,Marsel Ilhan,Hard,20,32,52,90,38.46
4770,Martijn Van Haasteren,Hard,3,1,4,4,75.0
4771,Martin Alund,Clay,7,9,16,16,43.75
4772,Martin Barba,Clay,1,1,2,7,50.0
4773,Martin Barba,Hard,1,4,5,7,20.0
4774,Martin Blackman,Carpet,1,1,2,11,50.0
4775,Martin Blackman,Hard,2,7,9,11,22.22
4776,Martin Cuevas,Clay,3,12,15,20,20.0
4777,Martin Cuevas,Hard,1,4,5,20,20.0
4778,Martin Damm,Carpet,53,50,103,370,51.46
4779,Martin Damm,Clay,6,28,34,370,17.65
4780,Martin Damm,Grass,23,26,49,370,46.94
4781,Martin Damm,Hard,76,108,184,370,41.3
4782,Martin Fischer,Clay,1,11,12,25,8.33
4783,Martin Fischer,Grass,1,3,4,25,25.0
4784,Martin Fischer,Hard,3,6,9,25,33.33
4785,Martin Hipp,Clay,1,1,2,2,50.0
4786,Martin Jaite,Carpet,15,16,31,480,48.39
4787,Martin Jaite,Clay,231,117,348,480,66.38
4788,Martin Jaite,Grass,4,5,9,480,44.44
4789,Martin Jaite,Hard,51,41,92,480,55.43
4790,Martin Klizan,Clay,73,59,132,299,55.3
4791,Martin Klizan,Grass,4,13,17,299,23.53
4792,Martin Klizan,Hard,67,83,150,299,44.67
4793,Martin Laurendeau,Carpet,5,7,12,93,41.67
4794,Martin Laurendeau,Grass,5,8,13,93,38.46
4795,Martin Laurendeau,Hard,26,42,68,93,38.24
4796,Martin Lee,Carpet,1,2,3,67,33.33
4797,Martin Lee,Clay,2,8,10,67,20.0
4798,Martin Lee,Grass,15,23,38,67,39.47
4799,Martin Lee,Hard,3,13,16,67,18.75
4800,Martin Mulligan,Clay,79,46,125,148,63.2
4801,Martin Mulligan,Grass,1,3,4,148,25.0
4802,Martin Mulligan,Hard,7,12,19,148,36.84
4803,Martin Pedersen,Clay,5,3,8,20,62.5
4804,Martin Pedersen,Hard,5,7,12,20,41.67
4805,Martin Robinson,Clay,10,24,34,43,29.41
4806,Martin Robinson,Grass,1,6,7,43,14.29
4807,Martin Robinson,Hard,1,1,2,43,50.0
4808,Martin Rodriguez,Clay,14,27,41,55,34.15
4809,Martin Rodriguez,Hard,2,12,14,55,14.29
4810,Martin Sayer,Hard,3,3,6,6,50.0
4811,Martin Sinner,Carpet,21,23,44,128,47.73
4812,Martin Sinner,Clay,13,28,41,128,31.71
4813,Martin Sinner,Grass,1,6,7,128,14.29
4814,Martin Sinner,Hard,15,21,36,128,41.67
4815,Martin Slanar,Hard,1,2,3,3,33.33
4816,Martin Spottl,Clay,2,2,4,4,50.0
4817,Martin Strelba,Carpet,3,9,12,106,25.0
4818,Martin Strelba,Clay,38,47,85,106,44.71
4819,Martin Strelba,Hard,1,8,9,106,11.11
4820,Martin Stringari,Clay,4,9,13,18,30.77
4821,Martin Stringari,Hard,2,3,5,18,40.0
4822,Martin Vassallo Arguello,Clay,41,53,94,128,43.62
4823,Martin Vassallo Arguello,Grass,2,5,7,128,28.57
4824,Martin Vassallo Arguello,Hard,4,23,27,128,14.81
4825,Martin Verkerk,Carpet,8,6,14,130,57.14
4826,Martin Verkerk,Clay,32,31,63,130,50.79
4827,Martin Verkerk,Grass,3,6,9,130,33.33
4828,Martin Verkerk,Hard,17,27,44,130,38.64
4829,Martin Vilarrubi,Clay,4,4,8,8,50.0
4830,Martin Wostenholme,Carpet,6,6,12,143,50.0
4831,Martin Wostenholme,Clay,28,43,71,143,39.44
4832,Martin Wostenholme,Grass,3,4,7,143,42.86
4833,Martin Wostenholme,Hard,19,34,53,143,35.85
4834,Martins Podzus,Clay,2,3,5,11,40.0
4835,Martins Podzus,Hard,2,4,6,11,33.33
4836,Marton Fucsovics,Carpet,2,2,4,169,50.0
4837,Marton Fucsovics,Clay,30,24,54,169,55.56
4838,Marton Fucsovics,Grass,4,9,13,169,30.77
4839,Marton Fucsovics,Hard,49,49,98,169,50.0
4840,Marty Davis,Carpet,29,35,64,326,45.31
4841,Marty Davis,Clay,17,26,43,326,39.53
4842,Marty Davis,Grass,30,27,57,326,52.63
4843,Marty Davis,Hard,77,85,162,326,47.53
4844,Marty Riessen,Carpet,143,95,238,665,60.08
4845,Marty Riessen,Clay,94,50,144,665,65.28
4846,Marty Riessen,Grass,64,39,103,665,62.14
4847,Marty Riessen,Hard,105,75,180,665,58.33
4848,Marzio Martelli,Carpet,1,2,3,51,33.33
4849,Marzio Martelli,Clay,12,22,34,51,35.29
4850,Marzio Martelli,Grass,1,2,3,51,33.33
4851,Marzio Martelli,Hard,5,6,11,51,45.45
4852,Mashiska Washington,Hard,5,11,16,16,31.25
4853,Massimiliano Narducci,Clay,16,18,34,40,47.06
4854,Massimiliano Narducci,Grass,1,2,3,40,33.33
4855,Massimiliano Narducci,Hard,1,2,3,40,33.33
4856,Massimo Ardinghi,Clay,1,4,5,5,20.0
4857,Massimo Calvelli,Clay,1,1,2,2,50.0
4858,Massimo Cierro,Clay,18,43,61,61,29.51
4859,Massimo Dellacqua,Grass,1,1,2,2,50.0
4860,Massimo Di Domenico,Clay,13,28,41,41,31.71
4861,Massimo Rivaroli,Carpet,1,2,3,3,33.33
4862,Massimo Valeri,Clay,3,8,11,11,27.27
4863,Massimo Zampieri,Clay,1,2,3,3,33.33
4864,Mate Delic,Clay,3,8,11,11,27.27
4865,Mate Pavic,Clay,1,5,6,12,16.67
4866,Mate Pavic,Grass,2,4,6,12,33.33
4867,Mathias Bourgue,Clay,1,2,3,3,33.33
4868,Mathias Werren,Clay,2,10,12,14,16.67
4869,Mathias Werren,Grass,1,1,2,14,50.0
4870,Mathieu Montcourt,Clay,5,6,11,11,45.45
4871,Mathieu Rodrigues,Hard,1,1,2,2,50.0
4872,Matias Boeker,Hard,1,3,4,4,25.0
4873,Matias Silva,Clay,4,3,7,9,57.14
4874,Matias Silva,Hard,1,1,2,9,50.0
4875,Mats Wilander,Carpet,72,53,125,794,57.6
4876,Mats Wilander,Clay,263,80,343,794,76.68
4877,Mats Wilander,Grass,49,17,66,794,74.24
4878,Mats Wilander,Hard,186,74,260,794,71.54
4879,Matt Anger,Carpet,6,15,21,188,28.57
4880,Matt Anger,Clay,4,7,11,188,36.36
4881,Matt Anger,Grass,26,23,49,188,53.06
4882,Matt Anger,Hard,46,61,107,188,42.99
4883,Matt Doyle,Carpet,7,4,11,140,63.64
4884,Matt Doyle,Clay,8,17,25,140,32.0
4885,Matt Doyle,Grass,10,14,24,140,41.67
4886,Matt Doyle,Hard,39,41,80,140,48.75
4887,Matt Mitchell,Carpet,17,23,40,163,42.5
4888,Matt Mitchell,Clay,5,14,19,163,26.32
4889,Matt Mitchell,Grass,17,27,44,163,38.64
4890,Matt Mitchell,Hard,21,39,60,163,35.0
4891,Matteo Berrettini,Clay,28,14,42,133,66.67
4892,Matteo Berrettini,Grass,13,5,18,133,72.22
4893,Matteo Berrettini,Hard,38,35,73,133,52.05
4894,Matteo Donati,Clay,1,1,2,2,50.0
4895,Matteo Viola,Hard,4,8,12,12,33.33
4896,Matthew Barton,Clay,1,1,2,8,50.0
4897,Matthew Barton,Grass,1,1,2,8,50.0
4898,Matthew Barton,Hard,2,2,4,8,50.0
4899,Matthew Ebden,Clay,1,13,14,200,7.14
4900,Matthew Ebden,Grass,20,25,45,200,44.44
4901,Matthew Ebden,Hard,55,86,141,200,39.01
4902,Matthew McDonald,Carpet,1,2,3,3,33.33
4903,Matthias Bachinger,Clay,11,19,30,86,36.67
4904,Matthias Bachinger,Grass,2,7,9,86,22.22
4905,Matthias Bachinger,Hard,18,29,47,86,38.3
4906,Matti Timonen,Carpet,3,4,7,16,42.86
4907,Matti Timonen,Clay,1,6,7,16,14.29
4908,Matti Timonen,Grass,1,1,2,16,50.0
4909,Maurice Ruah,Carpet,1,5,6,92,16.67
4910,Maurice Ruah,Clay,11,15,26,92,42.31
4911,Maurice Ruah,Grass,2,6,8,92,25.0
4912,Maurice Ruah,Hard,23,29,52,92,44.23
4913,Mauricio Doria Medina,Clay,1,2,3,6,33.33
4914,Mauricio Doria Medina,Hard,1,2,3,6,33.33
4915,Mauricio Echazu,Clay,12,12,24,27,50.0
4916,Mauricio Echazu,Hard,1,2,3,27,33.33
4917,Mauricio Hadad,Clay,44,24,68,115,64.71
4918,Mauricio Hadad,Hard,22,25,47,115,46.81
4919,Maurizio Aracri,Clay,1,1,2,2,50.0
4920,Mauro Menezes,Carpet,1,3,4,16,25.0
4921,Mauro Menezes,Hard,2,10,12,16,16.67
4922,Max Cocks,Grass,3,2,5,5,60.0
4923,Max Franklin,Grass,3,2,5,5,60.0
4924,Max Hurlimann,Clay,1,7,8,8,12.5
4925,Max Mirnyi,Carpet,43,30,73,487,58.9
4926,Max Mirnyi,Clay,41,60,101,487,40.59
4927,Max Mirnyi,Grass,30,26,56,487,53.57
4928,Max Mirnyi,Hard,131,126,257,487,50.97
4929,Max Pettman,Grass,1,3,4,4,25.0
4930,Max Purcell,Hard,1,2,3,3,33.33
4931,Max Senior,Grass,1,4,5,5,20.0
4932,Max Wunschig,Clay,5,11,16,16,31.25
4933,Maxim Dubarenco,Clay,2,1,3,9,66.67
4934,Maxim Dubarenco,Hard,3,3,6,9,50.0
4935,Maxime Cressy,Hard,3,4,7,7,42.86
4936,Maxime Huard,Carpet,2,1,3,3,66.67
4937,Maxime Teixeira,Clay,1,3,4,4,25.0
4938,Maximilian Abel,Clay,1,2,3,8,33.33
4939,Maximilian Abel,Hard,1,4,5,8,20.0
4940,Maximilian Marterer,Clay,14,21,35,74,40.0
4941,Maximilian Marterer,Grass,1,6,7,74,14.29
4942,Maximilian Marterer,Hard,10,22,32,74,31.25
4943,Maximo Gonzalez,Clay,27,43,70,86,38.57
4944,Maximo Gonzalez,Hard,3,13,16,86,18.75
4945,Mehdi Benyebka,Clay,1,1,2,2,50.0
4946,Mehdi Tahiri,Clay,5,17,22,26,22.73
4947,Mehdi Tahiri,Hard,2,2,4,26,50.0
4948,Mel Purcell,Carpet,22,33,55,355,40.0
4949,Mel Purcell,Clay,89,65,154,355,57.79
4950,Mel Purcell,Grass,8,9,17,355,47.06
4951,Mel Purcell,Hard,72,57,129,355,55.81
4952,Melle Van Gemerden,Clay,2,3,5,11,40.0
4953,Melle Van Gemerden,Grass,1,1,2,11,50.0
4954,Melle Van Gemerden,Hard,1,3,4,11,25.0
4955,Melvin Tong,Hard,6,8,14,14,42.86
4956,Menno Oosting,Carpet,2,5,7,64,28.57
4957,Menno Oosting,Clay,13,18,31,64,41.94
4958,Menno Oosting,Grass,2,3,5,64,40.0
4959,Menno Oosting,Hard,10,11,21,64,47.62
4960,Mert Ertunga,Clay,1,3,4,4,25.0
4961,Merv Guse,Grass,1,1,2,2,50.0
4962,Mervyn Rose,Grass,3,6,9,13,33.33
4963,Mervyn Rose,Hard,1,3,4,13,25.0
4964,Michael Appleton,Grass,1,1,2,2,50.0
4965,Michael Berrer,Carpet,1,1,2,233,50.0
4966,Michael Berrer,Clay,14,33,47,233,29.79
4967,Michael Berrer,Grass,7,17,24,233,29.17
4968,Michael Berrer,Hard,66,94,160,233,41.25
4969,Michael Brown B395,Clay,3,1,4,11,75.0
4970,Michael Brown B395,Hard,4,3,7,11,57.14
4971,Michael Burgener,Clay,1,4,5,5,20.0
4972,Michael Chang,Carpet,117,58,175,978,66.86
4973,Michael Chang,Clay,107,59,166,978,64.46
4974,Michael Chang,Grass,30,25,55,978,54.55
4975,Michael Chang,Hard,410,172,582,978,70.45
4976,Michael Geserer,Clay,1,5,6,9,16.67
4977,Michael Geserer,Hard,1,2,3,9,33.33
4978,Michael Grant,Clay,10,18,28,43,35.71
4979,Michael Grant,Hard,5,10,15,43,33.33
4980,Michael Hickey,Clay,3,6,9,17,33.33
4981,Michael Hickey,Grass,3,5,8,17,37.5
4982,Michael Hill,Hard,2,3,5,5,40.0
4983,Michael Joyce,Carpet,1,8,9,113,11.11
4984,Michael Joyce,Clay,1,5,6,113,16.67
4985,Michael Joyce,Grass,7,9,16,113,43.75
4986,Michael Joyce,Hard,37,45,82,113,45.12
4987,Michael Kohlmann,Carpet,2,5,7,74,28.57
4988,Michael Kohlmann,Clay,12,16,28,74,42.86
4989,Michael Kohlmann,Grass,5,9,14,74,35.71
4990,Michael Kohlmann,Hard,6,19,25,74,24.0
4991,Michael Kures,Clay,3,1,4,29,75.0
4992,Michael Kures,Hard,7,18,25,29,28.0
4993,Michael Lai,Hard,4,3,7,7,57.14
4994,Michael Lammer,Clay,1,10,11,29,9.09
4995,Michael Lammer,Hard,6,12,18,29,33.33
4996,Michael Leong,Hard,11,10,21,21,52.38
4997,Michael Llodra,Carpet,10,17,27,410,37.04
4998,Michael Llodra,Clay,20,40,60,410,33.33
4999,Michael Llodra,Grass,44,30,74,410,59.46
5000,Michael Llodra,Hard,113,136,249,410,45.38
5001,Michael Mcclune,Hard,1,2,3,3,33.33
5002,Michael Mmoh,Hard,10,19,29,29,34.48
5003,Michael Mortensen,Carpet,1,3,4,28,25.0
5004,Michael Mortensen,Clay,12,10,22,28,54.55
5005,Michael Mortensen,Hard,1,1,2,28,50.0
5006,Michael Nugent,Hard,1,2,3,3,33.33
5007,Michael Phillips,Grass,2,4,6,10,33.33
5008,Michael Phillips,Hard,2,2,4,10,50.0
5009,Michael Quintero,Clay,7,3,10,12,70.0
5010,Michael Quintero,Hard,1,1,2,12,50.0
5011,Michael Robertson,Carpet,1,3,4,69,25.0
5012,Michael Robertson,Clay,4,12,16,69,25.0
5013,Michael Robertson,Grass,2,6,8,69,25.0
5014,Michael Robertson,Hard,16,25,41,69,39.02
5015,Michael Russell,Clay,12,35,47,227,25.53
5016,Michael Russell,Grass,10,23,33,227,30.3
5017,Michael Russell,Hard,55,92,147,227,37.41
5018,Michael Ryderstedt,Clay,3,6,9,25,33.33
5019,Michael Ryderstedt,Hard,5,11,16,25,31.25
5020,Michael Sangster,Grass,1,2,3,3,33.33
5021,Michael Sell,Hard,6,11,17,17,35.29
5022,Michael Sprenglemeyer,Clay,2,2,4,4,50.0
5023,Michael Stich,Carpet,98,47,145,564,67.59
5024,Michael Stich,Clay,105,52,157,564,66.88
5025,Michael Stich,Grass,61,17,78,564,78.21
5026,Michael Stich,Hard,122,62,184,564,66.3
5027,Michael Tauson,Carpet,13,7,20,53,65.0
5028,Michael Tauson,Clay,14,12,26,53,53.85
5029,Michael Tauson,Hard,1,6,7,53,14.29
5030,Michael Tebbutt,Carpet,11,12,23,148,47.83
5031,Michael Tebbutt,Clay,8,12,20,148,40.0
5032,Michael Tebbutt,Grass,4,11,15,148,26.67
5033,Michael Tebbutt,Hard,41,49,90,148,45.56
5034,Michael Venus,Clay,3,1,4,25,75.0
5035,Michael Venus,Hard,6,15,21,25,28.57
5036,Michael Walker,Hard,8,7,15,15,53.33
5037,Michael Wayman,Clay,1,2,3,14,33.33
5038,Michael Wayman,Grass,2,5,7,14,28.57
5039,Michael Wayman,Hard,1,3,4,14,25.0
5040,Michael Westphal,Carpet,9,12,21,194,42.86
5041,Michael Westphal,Clay,42,50,92,194,45.65
5042,Michael Westphal,Grass,1,3,4,194,25.0
5043,Michael Westphal,Hard,35,42,77,194,45.45
5044,Michael Yani,Grass,3,2,5,14,60.0
5045,Michael Yani,Hard,1,8,9,14,11.11
5046,Michail Elgin,Hard,3,5,8,8,37.5
5047,Michal Chmela,Clay,2,2,4,8,50.0
5048,Michal Chmela,Hard,2,2,4,8,50.0
5049,Michal Gawlowski,Carpet,2,1,3,3,66.67
5050,Michal Lewandowski,Clay,1,1,2,2,50.0
5051,Michal Mertinak,Clay,5,7,12,25,41.67
5052,Michal Mertinak,Grass,2,5,7,25,28.57
5053,Michal Mertinak,Hard,3,3,6,25,50.0
5054,Michal Przysiezny,Carpet,5,1,6,104,83.33
5055,Michal Przysiezny,Clay,6,23,29,104,20.69
5056,Michal Przysiezny,Grass,4,8,12,104,33.33
5057,Michal Przysiezny,Hard,16,41,57,104,28.07
5058,Michal Tabara,Carpet,2,6,8,93,25.0
5059,Michal Tabara,Clay,20,25,45,93,44.44
5060,Michal Tabara,Hard,18,22,40,93,45.0
5061,Michel Kratochvil,Carpet,5,9,14,171,35.71
5062,Michel Kratochvil,Clay,18,29,47,171,38.3
5063,Michel Kratochvil,Grass,11,10,21,171,52.38
5064,Michel Kratochvil,Hard,39,50,89,171,43.82
5065,Michele Leclercq,Carpet,2,3,5,35,40.0
5066,Michele Leclercq,Clay,12,11,23,35,52.17
5067,Michele Leclercq,Hard,3,4,7,35,42.86
5068,Michiel Schapers,Carpet,36,41,77,356,46.75
5069,Michiel Schapers,Clay,26,44,70,356,37.14
5070,Michiel Schapers,Grass,33,26,59,356,55.93
5071,Michiel Schapers,Hard,73,77,150,356,48.67
5072,Micke Kontinen,Hard,2,3,5,5,40.0
5073,Micky Dominguez,Hard,1,3,4,4,25.0
5074,Midodji Segbeaya,Hard,2,1,3,3,66.67
5075,Miguel Angel Lopez Jaen,Clay,1,2,3,3,33.33
5076,Miguel Angel Reyes Varela,Hard,3,2,5,5,60.0
5077,Miguel Dungo,Hard,1,1,2,2,50.0
5078,Miguel Gallardo Valles,Carpet,2,3,5,34,40.0
5079,Miguel Gallardo Valles,Clay,7,9,16,34,43.75
5080,Miguel Gallardo Valles,Hard,8,5,13,34,61.54
5081,Miguel Merz,Clay,2,2,4,4,50.0
5082,Miguel Mir,Carpet,2,6,8,37,25.0
5083,Miguel Mir,Clay,4,20,24,37,16.67
5084,Miguel Mir,Hard,1,4,5,37,20.0
5085,Miguel Nido,Carpet,3,2,5,41,60.0
5086,Miguel Nido,Clay,4,7,11,41,36.36
5087,Miguel Nido,Hard,11,14,25,41,44.0
5088,Miguel Olvera,Clay,7,10,17,26,41.18
5089,Miguel Olvera,Grass,2,2,4,26,50.0
5090,Miguel Olvera,Hard,4,1,5,26,80.0
5091,Miguel Oquendo,Clay,1,1,2,2,50.0
5092,Miguel Soares,Clay,1,5,6,6,16.67
5093,Miguel Tobon,Clay,18,15,33,41,54.55
5094,Miguel Tobon,Hard,3,5,8,41,37.5
5095,Mihai Vanta,Clay,1,1,2,2,50.0
5096,Mik Ledvonova,Hard,1,1,2,2,50.0
5097,Mikael Pernfors,Carpet,20,20,40,255,50.0
5098,Mikael Pernfors,Clay,38,42,80,255,47.5
5099,Mikael Pernfors,Grass,8,4,12,255,66.67
5100,Mikael Pernfors,Hard,75,48,123,255,60.98
5101,Mikael Stadling,Carpet,1,5,6,6,16.67
5102,Mikael Tillstrom,Carpet,14,15,29,226,48.28
5103,Mikael Tillstrom,Clay,31,35,66,226,46.97
5104,Mikael Tillstrom,Grass,3,8,11,226,27.27
5105,Mikael Tillstrom,Hard,65,55,120,226,54.17
5106,Mikael Torpegaard,Carpet,1,1,2,10,50.0
5107,Mikael Torpegaard,Hard,3,5,8,10,37.5
5108,Mikael Ymer,Clay,5,7,12,47,41.67
5109,Mikael Ymer,Hard,16,19,35,47,45.71
5110,Mike Bauer,Carpet,24,17,41,166,58.54
5111,Mike Bauer,Clay,2,13,15,166,13.33
5112,Mike Bauer,Grass,30,23,53,166,56.6
5113,Mike Bauer,Hard,19,38,57,166,33.33
5114,Mike Belkin,Clay,44,24,68,105,64.71
5115,Mike Belkin,Grass,4,4,8,105,50.0
5116,Mike Belkin,Hard,13,16,29,105,44.83
5117,Mike Brown,Hard,2,1,3,3,66.67
5118,Mike Brunnberg,Clay,2,3,5,22,40.0
5119,Mike Brunnberg,Grass,4,6,10,22,40.0
5120,Mike Brunnberg,Hard,3,4,7,22,42.86
5121,Mike Bryan,Grass,1,3,4,14,25.0
5122,Mike Bryan,Hard,4,6,10,14,40.0
5123,Mike Cahill,Carpet,18,44,62,252,29.03
5124,Mike Cahill,Clay,50,66,116,252,43.1
5125,Mike Cahill,Hard,34,40,74,252,45.95
5126,Mike Collins,Grass,5,5,10,10,50.0
5127,Mike De Palmer,Carpet,14,12,26,161,53.85
5128,Mike De Palmer,Clay,11,13,24,161,45.83
5129,Mike De Palmer,Grass,14,18,32,161,43.75
5130,Mike De Palmer,Hard,37,42,79,161,46.84
5131,Mike Estep,Carpet,13,34,47,259,27.66
5132,Mike Estep,Clay,13,47,60,259,21.67
5133,Mike Estep,Grass,33,29,62,259,53.23
5134,Mike Estep,Hard,41,49,90,259,45.56
5135,Mike Fishbach,Carpet,3,8,11,50,27.27
5136,Mike Fishbach,Clay,13,26,39,50,33.33
5137,Mike Gandolfo,Carpet,2,3,5,9,40.0
5138,Mike Gandolfo,Grass,2,2,4,9,50.0
5139,Mike Harrington,Clay,1,1,2,6,50.0
5140,Mike Harrington,Hard,2,2,4,6,50.0
5141,Mike Kreiss,Clay,1,5,6,19,16.67
5142,Mike Kreiss,Hard,2,11,13,19,15.38
5143,Mike Leach,Carpet,23,19,42,176,54.76
5144,Mike Leach,Clay,12,16,28,176,42.86
5145,Mike Leach,Grass,15,24,39,176,38.46
5146,Mike Leach,Hard,24,43,67,176,35.82
5147,Mike Lee,Grass,2,2,4,4,50.0
5148,Mike Machette,Carpet,3,14,17,102,17.65
5149,Mike Machette,Clay,1,12,13,102,7.69
5150,Mike Machette,Grass,12,23,35,102,34.29
5151,Mike Machette,Hard,9,28,37,102,24.32
5152,Mike Myburg,Clay,8,9,17,31,47.06
5153,Mike Myburg,Hard,1,13,14,31,7.14
5154,Mike Powers,Clay,1,3,4,4,25.0
5155,Mike Scheidweiler,Carpet,1,1,2,21,50.0
5156,Mike Scheidweiler,Clay,3,5,8,21,37.5
5157,Mike Scheidweiler,Hard,3,8,11,21,27.27
5158,Mike Shore,Hard,3,3,6,6,50.0
5159,Mikelis Libietis,Hard,1,3,4,4,25.0
5160,Mikhail Filima,Hard,2,1,3,3,66.67
5161,Mikhail Kukushkin,Carpet,1,2,3,377,33.33
5162,Mikhail Kukushkin,Clay,36,59,95,377,37.89
5163,Mikhail Kukushkin,Grass,15,23,38,377,39.47
5164,Mikhail Kukushkin,Hard,114,127,241,377,47.3
5165,Mikhail Ledovskikh,Carpet,1,2,3,16,33.33
5166,Mikhail Ledovskikh,Grass,1,4,5,16,20.0
5167,Mikhail Ledovskikh,Hard,2,6,8,16,25.0
5168,Mikhail Youzhny,Carpet,36,23,59,922,61.02
5169,Mikhail Youzhny,Clay,134,128,262,922,51.15
5170,Mikhail Youzhny,Grass,61,47,108,922,56.48
5171,Mikhail Youzhny,Hard,268,225,493,922,54.36
5172,Milan Holecek,Carpet,8,18,26,250,30.77
5173,Milan Holecek,Clay,47,65,112,250,41.96
5174,Milan Holecek,Grass,15,19,34,250,44.12
5175,Milan Holecek,Hard,34,44,78,250,43.59
5176,Milan Srejber,Carpet,36,28,64,257,56.25
5177,Milan Srejber,Clay,35,44,79,257,44.3
5178,Milan Srejber,Grass,7,9,16,257,43.75
5179,Milan Srejber,Hard,50,48,98,257,51.02
5180,Milan Tajenar,Hard,1,1,2,2,50.0
5181,Milen Velev,Clay,12,11,23,23,52.17
5182,Miles Maclagan,Clay,1,6,7,14,14.29
5183,Miles Maclagan,Grass,2,5,7,14,28.57
5184,Miljan Zekic,Clay,1,2,3,3,33.33
5185,Milko Petkov,Clay,2,2,4,4,50.0
5186,Milos Raonic,Clay,65,38,103,555,63.11
5187,Milos Raonic,Grass,49,23,72,555,68.06
5188,Milos Raonic,Hard,260,120,380,555,68.42
5189,Miloslav Mecir,Carpet,54,31,85,384,63.53
5190,Miloslav Mecir,Clay,96,48,144,384,66.67
5191,Miloslav Mecir,Grass,34,17,51,384,66.67
5192,Miloslav Mecir,Hard,77,27,104,384,74.04
5193,Miloslav Mecir Jr,Hard,1,2,3,3,33.33
5194,Min Hyoek Cho,Hard,2,4,6,6,33.33
5195,Minh Quan Do,Hard,1,1,2,2,50.0
5196,Minoru Ueda,Hard,1,2,3,3,33.33
5197,Miomir Kecmanovic,Clay,6,6,12,80,50.0
5198,Miomir Kecmanovic,Grass,6,4,10,80,60.0
5199,Miomir Kecmanovic,Hard,30,28,58,80,51.72
5200,Mirza Basic,Clay,6,11,17,65,35.29
5201,Mirza Basic,Grass,2,4,6,65,33.33
5202,Mirza Basic,Hard,21,21,42,65,50.0
5203,Mischa Zverev,Clay,25,54,79,332,31.65
5204,Mischa Zverev,Grass,30,30,60,332,50.0
5205,Mischa Zverev,Hard,79,114,193,332,40.93
5206,Mitchell Krueger,Hard,3,7,10,10,30.0
5207,Moataz El Sonbol,Clay,2,3,5,5,40.0
5208,Modesto Tito Vazquez,Clay,4,16,20,38,20.0
5209,Modesto Tito Vazquez,Grass,6,6,12,38,50.0
5210,Modesto Tito Vazquez,Hard,2,4,6,38,33.33
5211,Mohamed Dlimi,Clay,2,4,6,10,33.33
5212,Mohamed Dlimi,Hard,3,1,4,10,75.0
5213,Mohamed Mamoun,Clay,4,3,7,10,57.14
5214,Mohamed Mamoun,Hard,1,2,3,10,33.33
5215,Mohamed Ridaoui,Clay,8,4,12,16,66.67
5216,Mohamed Ridaoui,Hard,2,2,4,16,50.0
5217,Mohamed Safwat,Clay,3,7,10,28,30.0
5218,Mohamed Safwat,Grass,1,1,2,28,50.0
5219,Mohamed Safwat,Hard,4,12,16,28,25.0
5220,Mohammad Ghareeb,Clay,7,2,9,41,77.78
5221,Mohammad Ghareeb,Hard,19,13,32,41,59.38
5222,Mohammad Hossein Akbari,Clay,1,3,4,4,25.0
5223,Mohammed Al Nabhani,Hard,2,6,8,8,25.0
5224,Mohammed Khalid,Grass,1,1,2,8,50.0
5225,Mohammed Khalid,Hard,3,3,6,8,50.0
5226,Mohammed Reza Tavakoli,Clay,5,5,10,18,50.0
5227,Mohammed Reza Tavakoli,Hard,5,3,8,18,62.5
5228,Moharram Ali Khodai,Clay,2,4,6,6,33.33
5229,Mohd Assri Merzuki,Hard,1,2,3,3,33.33
5230,Moncef Zehar,Clay,1,3,4,4,25.0
5231,Morris Skip Strode,Carpet,6,8,14,36,42.86
5232,Morris Skip Strode,Clay,1,3,4,36,25.0
5233,Morris Skip Strode,Hard,10,8,18,36,55.56
5234,Morten Christensen,Carpet,7,13,20,20,35.0
5235,Morten Ronneberg,Clay,2,8,10,10,20.0
5236,Mose Navarra,Clay,2,4,6,11,33.33
5237,Mose Navarra,Grass,2,3,5,11,40.0
5238,Mounir El Aarej,Clay,7,14,21,23,33.33
5239,Mounir El Aarej,Grass,1,1,2,23,50.0
5240,Muhammad Khaliq Siddiq,Clay,3,1,4,21,75.0
5241,Muhammad Khaliq Siddiq,Grass,7,1,8,21,87.5
5242,Muhammad Khaliq Siddiq,Hard,2,7,9,21,22.22
5243,Mulari Dharan,Hard,1,2,3,3,33.33
5244,Munawar Iqbal,Grass,3,5,8,8,37.5
5245,Murad Inoyatov,Clay,2,2,4,11,50.0
5246,Murad Inoyatov,Hard,1,6,7,11,14.29
5247,Musaad Al Jazzaf,Hard,1,2,3,3,33.33
5248,Mushaf Zia,Hard,1,3,4,4,25.0
5249,Mustafa Azkara,Clay,1,1,2,4,50.0
5250,Mustafa Azkara,Hard,1,1,2,4,50.0
5251,Mustapha Dislam,Clay,1,3,4,4,25.0
5252,Na Sulistyono,Clay,1,1,2,2,50.0
5253,Nagy Kabaz,Hard,1,5,6,6,16.67
5254,Najdo Abou Hassoun,Clay,1,1,2,2,50.0
5255,Nam Hoang Ly,Hard,1,2,3,3,33.33
5256,Nandan Bal,Grass,1,1,2,2,50.0
5257,Naratorn Srichaphan,Clay,3,4,7,26,42.86
5258,Naratorn Srichaphan,Hard,10,9,19,26,52.63
5259,Nasser Ghanim Al Khulaifi,Hard,2,7,9,9,22.22
5260,Nathan Healey,Grass,1,1,2,18,50.0
5261,Nathan Healey,Hard,5,11,16,18,31.25
5262,Nduka Odizor,Carpet,13,20,33,224,39.39
5263,Nduka Odizor,Clay,13,16,29,224,44.83
5264,Nduka Odizor,Grass,31,30,61,224,50.82
5265,Nduka Odizor,Hard,39,62,101,224,38.61
5266,Neale Fraser,Clay,2,3,5,33,40.0
5267,Neale Fraser,Grass,8,14,22,33,36.36
5268,Neale Fraser,Hard,3,3,6,33,50.0
5269,Necvet Demir,Clay,2,9,11,11,18.18
5270,Ned Caswell,Hard,2,4,6,6,33.33
5271,Ned Neely,Grass,1,1,2,2,50.0
5272,Neil Borwick,Carpet,1,5,6,73,16.67
5273,Neil Borwick,Grass,5,9,14,73,35.71
5274,Neil Borwick,Hard,19,34,53,73,35.85
5275,Neil Broad,Grass,1,4,5,25,20.0
5276,Neil Broad,Hard,6,14,20,25,30.0
5277,Nelson Aerts,Carpet,1,1,2,37,50.0
5278,Nelson Aerts,Clay,3,8,11,37,27.27
5279,Nelson Aerts,Grass,2,6,8,37,25.0
5280,Nelson Aerts,Hard,7,9,16,37,43.75
5281,Nenad Zimonjic,Carpet,7,3,10,27,70.0
5282,Nenad Zimonjic,Clay,1,8,9,27,11.11
5283,Nenad Zimonjic,Grass,4,4,8,27,50.0
5284,Nerman Fatic,Hard,2,3,5,5,40.0
5285,Neville Godwin,Carpet,1,5,6,90,16.67
5286,Neville Godwin,Grass,16,13,29,90,55.17
5287,Neville Godwin,Hard,19,36,55,90,34.55
5288,Neville Nette,Grass,1,1,2,2,50.0
5289,Ney Keller,Carpet,1,2,3,3,33.33
5290,Nial Brash,Hard,1,2,3,3,33.33
5291,Nicholas Kalogeropoulos,Carpet,1,8,9,98,11.11
5292,Nicholas Kalogeropoulos,Clay,19,26,45,98,42.22
5293,Nicholas Kalogeropoulos,Grass,9,11,20,98,45.0
5294,Nicholas Kalogeropoulos,Hard,10,14,24,98,41.67
5295,Nicholas Sayer,Hard,2,2,4,4,50.0
5296,Nick Brown,Carpet,1,2,3,23,33.33
5297,Nick Brown,Grass,10,10,20,23,50.0
5298,Nick Fleury,Clay,1,3,4,9,25.0
5299,Nick Fleury,Hard,1,4,5,9,20.0
5300,Nick Fulwood,Grass,5,12,17,17,29.41
5301,Nick Kyrgios,Clay,26,19,45,260,57.78
5302,Nick Kyrgios,Grass,22,14,36,260,61.11
5303,Nick Kyrgios,Hard,118,61,179,260,65.92
5304,Nick Lindahl,Hard,1,7,8,8,12.5
5305,Nick Saviano,Carpet,35,50,85,360,41.18
5306,Nick Saviano,Clay,25,39,64,360,39.06
5307,Nick Saviano,Grass,30,31,61,360,49.18
5308,Nick Saviano,Hard,70,80,150,360,46.67
5309,Nick Van Rosberg,Hard,1,3,4,4,25.0
5310,Nicklas Kroon,Carpet,6,11,17,113,35.29
5311,Nicklas Kroon,Clay,12,22,34,113,35.29
5312,Nicklas Kroon,Grass,4,7,11,113,36.36
5313,Nicklas Kroon,Hard,26,25,51,113,50.98
5314,Nicklas Kulti,Carpet,33,34,67,337,49.25
5315,Nicklas Kulti,Clay,53,61,114,337,46.49
5316,Nicklas Kulti,Grass,15,13,28,337,53.57
5317,Nicklas Kulti,Hard,54,74,128,337,42.19
5318,Nicklas Utgren,Clay,6,11,17,20,35.29
5319,Nicklas Utgren,Hard,1,2,3,20,33.33
5320,Nicola Bruno,Hard,1,2,3,3,33.33
5321,Nicola Kuhn,Clay,1,1,2,8,50.0
5322,Nicola Kuhn,Hard,2,4,6,8,33.33
5323,Nicola Pietrangeli,Clay,35,22,57,74,61.4
5324,Nicola Pietrangeli,Grass,2,7,9,74,22.22
5325,Nicola Pietrangeli,Hard,5,3,8,74,62.5
5326,Nicola Spear,Carpet,3,9,12,232,25.0
5327,Nicola Spear,Clay,63,105,168,232,37.5
5328,Nicola Spear,Grass,3,16,19,232,15.79
5329,Nicola Spear,Hard,14,19,33,232,42.42
5330,Nicolaas Scholtz,Hard,2,6,8,8,25.0
5331,Nicolas Almagro,Carpet,3,3,6,679,50.0
5332,Nicolas Almagro,Clay,281,147,428,679,65.65
5333,Nicolas Almagro,Grass,14,16,30,679,46.67
5334,Nicolas Almagro,Hard,102,113,215,679,47.44
5335,Nicolas Alvarez,Clay,4,1,5,8,80.0
5336,Nicolas Alvarez,Hard,2,1,3,8,66.67
5337,Nicolas Coutelot,Clay,13,15,28,28,46.43
5338,Nicolas Devilder,Clay,17,27,44,71,38.64
5339,Nicolas Devilder,Grass,2,4,6,71,33.33
5340,Nicolas Devilder,Hard,5,16,21,71,23.81
5341,Nicolas Escude,Carpet,28,24,52,304,53.85
5342,Nicolas Escude,Clay,22,31,53,304,41.51
5343,Nicolas Escude,Grass,23,14,37,304,62.16
5344,Nicolas Escude,Hard,99,63,162,304,61.11
5345,Nicolas Jarry,Clay,38,25,63,110,60.32
5346,Nicolas Jarry,Grass,4,6,10,110,40.0
5347,Nicolas Jarry,Hard,11,26,37,110,29.73
5348,Nicolas Kelaidis,Clay,2,12,14,20,14.29
5349,Nicolas Kelaidis,Grass,2,4,6,20,33.33
5350,Nicolas Kicker,Clay,15,19,34,46,44.12
5351,Nicolas Kicker,Hard,4,8,12,46,33.33
5352,Nicolas Kiefer,Carpet,38,31,69,642,55.07
5353,Nicolas Kiefer,Clay,55,68,123,642,44.72
5354,Nicolas Kiefer,Grass,44,30,74,642,59.46
5355,Nicolas Kiefer,Hard,227,149,376,642,60.37
5356,Nicolas Kischkewitz,Clay,1,1,2,2,50.0
5357,Nicolas Lapentti,Carpet,18,20,38,621,47.37
5358,Nicolas Lapentti,Clay,182,142,324,621,56.17
5359,Nicolas Lapentti,Grass,11,19,30,621,36.67
5360,Nicolas Lapentti,Hard,112,117,229,621,48.91
5361,Nicolas Mahut,Carpet,3,11,14,407,21.43
5362,Nicolas Mahut,Clay,17,39,56,407,30.36
5363,Nicolas Mahut,Grass,67,41,108,407,62.04
5364,Nicolas Mahut,Hard,94,135,229,407,41.05
5365,Nicolas Massu,Carpet,12,12,24,497,50.0
5366,Nicolas Massu,Clay,162,119,281,497,57.65
5367,Nicolas Massu,Grass,6,12,18,497,33.33
5368,Nicolas Massu,Hard,79,95,174,497,45.4
5369,Nicolas Pereira,Carpet,5,10,15,214,33.33
5370,Nicolas Pereira,Clay,23,35,58,214,39.66
5371,Nicolas Pereira,Grass,11,18,29,214,37.93
5372,Nicolas Pereira,Hard,45,67,112,214,40.18
5373,Nicolas Renavand,Hard,1,1,2,2,50.0
5374,Nicolas Romero,Clay,1,1,2,2,50.0
5375,Nicolas Salama,Clay,1,1,2,2,50.0
5376,Nicolas Thomann,Carpet,4,6,10,39,40.0
5377,Nicolas Thomann,Clay,1,6,7,39,14.29
5378,Nicolas Thomann,Grass,1,2,3,39,33.33
5379,Nicolas Thomann,Hard,8,11,19,39,42.11
5380,Nik Razborsek,Hard,1,2,3,3,33.33
5381,Nikola Cacic,Clay,1,1,2,2,50.0
5382,Nikola Mektic,Clay,2,3,5,12,40.0
5383,Nikola Mektic,Hard,1,6,7,12,14.29
5384,Nikola Milojevic,Clay,2,2,4,8,50.0
5385,Nikola Milojevic,Hard,2,2,4,8,50.0
5386,Nikola Pilic,Carpet,62,55,117,447,52.99
5387,Nikola Pilic,Clay,97,81,178,447,54.49
5388,Nikola Pilic,Grass,53,23,76,447,69.74
5389,Nikola Pilic,Hard,42,34,76,447,55.26
5390,Nikola Soear,Clay,1,1,2,2,50.0
5391,Nikolay Davydenko,Carpet,34,18,52,822,65.38
5392,Nikolay Davydenko,Clay,185,120,305,822,60.66
5393,Nikolay Davydenko,Grass,10,20,30,822,33.33
5394,Nikolay Davydenko,Hard,255,180,435,822,58.62
5395,Nikoloz Basilashvili,Clay,30,33,63,210,47.62
5396,Nikoloz Basilashvili,Grass,7,12,19,210,36.84
5397,Nikoloz Basilashvili,Hard,59,69,128,210,46.09
5398,Nikos Rovas,Carpet,1,2,3,10,33.33
5399,Nikos Rovas,Clay,3,4,7,10,42.86
5400,Nils Elvik,Clay,1,3,4,4,25.0
5401,Nils Langer,Clay,1,1,2,2,50.0
5402,Nino Serdarusic,Clay,1,3,4,4,25.0
5403,Nir Welgreen,Hard,2,5,7,7,28.57
5404,Noah Rubin,Clay,1,4,5,26,20.0
5405,Noah Rubin,Hard,7,14,21,26,33.33
5406,Noam Behr,Hard,7,12,19,19,36.84
5407,Noam Okun,Carpet,1,3,4,94,25.0
5408,Noam Okun,Clay,4,6,10,94,40.0
5409,Noam Okun,Grass,3,6,9,94,33.33
5410,Noam Okun,Hard,28,43,71,94,39.44
5411,Nobuya Tamura,Clay,1,5,6,6,16.67
5412,Noel Phillips,Carpet,2,2,4,24,50.0
5413,Noel Phillips,Clay,2,5,7,24,28.57
5414,Noel Phillips,Grass,4,9,13,24,30.77
5415,Noel Rutherford,Hard,2,5,7,7,28.57
5416,Nomi Qamar,Hard,2,3,5,5,40.0
5417,Norbert Gombos,Clay,4,8,12,50,33.33
5418,Norbert Gombos,Hard,11,27,38,50,28.95
5419,Norbert Mazany,Clay,1,1,2,2,50.0
5420,Norbert Oduor,Clay,1,4,5,5,20.0
5421,Norberto Herrero,Clay,1,4,5,5,20.0
5422,Norm Perry,Clay,1,4,5,5,20.0
5423,Norm Schellenger,Clay,1,3,4,4,25.0
5424,Norman Holmes,Clay,19,40,59,74,32.2
5425,Norman Holmes,Grass,5,5,10,74,50.0
5426,Norman Holmes,Hard,1,4,5,74,20.0
5427,Nouhoun Sangare,Hard,2,1,3,3,66.67
5428,Novak Djokovic,Carpet,9,4,13,1147,69.23
5429,Novak Djokovic,Clay,230,56,286,1147,80.42
5430,Novak Djokovic,Grass,95,18,113,1147,84.07
5431,Novak Djokovic,Hard,621,114,735,1147,84.49
5432,Nuno Marques,Carpet,4,9,13,157,30.77
5433,Nuno Marques,Clay,35,60,95,157,36.84
5434,Nuno Marques,Grass,2,10,12,157,16.67
5435,Nuno Marques,Hard,15,22,37,157,40.54
5436,Ody Gabriel,Hard,2,1,3,3,66.67
5437,Ofer Sela,Hard,1,4,5,5,20.0
5438,Ognian Kolev,Hard,1,3,4,4,25.0
5439,Ola Kristiansson,Clay,1,3,4,4,25.0
5440,Oleg Ogorodov,Carpet,7,11,18,113,38.89
5441,Oleg Ogorodov,Clay,14,14,28,113,50.0
5442,Oleg Ogorodov,Grass,2,3,5,113,40.0
5443,Oleg Ogorodov,Hard,30,32,62,113,48.39
5444,Oleksandr Dolgopolov,Clay,1,1,2,2,50.0
5445,Oliver Fernandez,Clay,7,10,17,23,41.18
5446,Oliver Fernandez,Hard,2,4,6,23,33.33
5447,Oliver Gross,Clay,39,53,92,122,42.39
5448,Oliver Gross,Hard,10,20,30,122,33.33
5449,Oliver Marach,Carpet,1,2,3,52,33.33
5450,Oliver Marach,Clay,15,20,35,52,42.86
5451,Oliver Marach,Hard,4,10,14,52,28.57
5452,Olivier Delaitre,Carpet,35,37,72,309,48.61
5453,Olivier Delaitre,Clay,18,48,66,309,27.27
5454,Olivier Delaitre,Grass,8,11,19,309,42.11
5455,Olivier Delaitre,Hard,69,83,152,309,45.39
5456,Olivier Mutis,Clay,19,22,41,63,46.34
5457,Olivier Mutis,Grass,2,3,5,63,40.0
5458,Olivier Mutis,Hard,3,14,17,63,17.65
5459,Olivier Patience,Clay,19,34,53,78,35.85
5460,Olivier Patience,Grass,3,3,6,78,50.0
5461,Olivier Patience,Hard,4,15,19,78,21.05
5462,Olivier Rochus,Carpet,14,13,27,515,51.85
5463,Olivier Rochus,Clay,61,94,155,515,39.35
5464,Olivier Rochus,Grass,43,38,81,515,53.09
5465,Olivier Rochus,Hard,120,132,252,515,47.62
5466,Olivier Sajous,Hard,4,3,7,7,57.14
5467,Olle Palmer,Carpet,1,1,2,5,50.0
5468,Olle Palmer,Hard,1,2,3,5,33.33
5469,Olli Rahnasto,Carpet,5,5,10,51,50.0
5470,Olli Rahnasto,Clay,10,6,16,51,62.5
5471,Olli Rahnasto,Grass,1,3,4,51,25.0
5472,Olli Rahnasto,Hard,8,13,21,51,38.1
5473,Omar Camporese,Carpet,44,39,83,307,53.01
5474,Omar Camporese,Clay,71,83,154,307,46.1
5475,Omar Camporese,Grass,5,8,13,307,38.46
5476,Omar Camporese,Hard,30,27,57,307,52.63
5477,Omar Jasika,Hard,1,3,4,4,25.0
5478,Omar Laimina,Clay,9,5,14,14,64.29
5479,Omer Rashid,Clay,4,3,7,17,57.14
5480,Omer Rashid,Grass,1,5,6,17,16.67
5481,Omer Rashid,Hard,3,1,4,17,75.0
5482,Onny Parun,Carpet,38,48,86,664,44.19
5483,Onny Parun,Clay,140,131,271,664,51.66
5484,Onny Parun,Grass,88,58,146,664,60.27
5485,Onny Parun,Hard,86,75,161,664,53.42
5486,Orest Tereshchuk,Carpet,4,1,5,18,80.0
5487,Orest Tereshchuk,Clay,4,3,7,18,57.14
5488,Orest Tereshchuk,Hard,4,2,6,18,66.67
5489,Oriol Roca Batalla,Clay,1,1,2,2,50.0
5490,Orlando Agudelo,Clay,1,6,7,7,14.29
5491,Orlando Lourenco,Clay,3,3,6,14,50.0
5492,Orlando Lourenco,Hard,6,2,8,14,75.0
5493,Orlin Stanoytchev,Carpet,1,4,5,73,20.0
5494,Orlin Stanoytchev,Clay,13,30,43,73,30.23
5495,Orlin Stanoytchev,Grass,1,5,6,73,16.67
5496,Orlin Stanoytchev,Hard,4,15,19,73,21.05
5497,Oscar Blacutt,Clay,2,2,4,4,50.0
5498,Oscar Burrieza,Grass,2,5,7,18,28.57
5499,Oscar Burrieza,Hard,2,9,11,18,18.18
5500,Oscar Bustos,Carpet,1,1,2,2,50.0
5501,Oscar Hernandez,Clay,59,84,143,190,41.26
5502,Oscar Hernandez,Grass,1,9,10,190,10.0
5503,Oscar Hernandez,Hard,5,32,37,190,13.51
5504,Oscar Martinez,Clay,19,25,44,44,43.18
5505,Oscar Ortiz,Hard,1,4,5,5,20.0
5506,Oscar Otte,Clay,1,2,3,11,33.33
5507,Oscar Otte,Hard,3,5,8,11,37.5
5508,Oscar Serrano,Clay,6,12,18,18,33.33
5509,Ota Fukarek,Grass,1,2,3,13,33.33
5510,Ota Fukarek,Hard,1,9,10,13,10.0
5511,Otavio Della,Hard,1,3,4,4,25.0
5512,Othman Al Anazi,Hard,2,2,4,4,50.0
5513,Otto Virtanen,Clay,1,1,2,2,50.0
5514,Ove Nils Bengtson,Carpet,31,45,76,280,40.79
5515,Ove Nils Bengtson,Clay,19,41,60,280,31.67
5516,Ove Nils Bengtson,Grass,19,22,41,280,46.34
5517,Ove Nils Bengtson,Hard,45,58,103,280,43.69
5518,Owen Casey,Carpet,9,2,11,23,81.82
5519,Owen Casey,Clay,1,5,6,23,16.67
5520,Owen Casey,Hard,3,3,6,23,50.0
5521,Owen Davidson,Carpet,7,22,29,174,24.14
5522,Owen Davidson,Clay,15,25,40,174,37.5
5523,Owen Davidson,Grass,40,25,65,174,61.54
5524,Owen Davidson,Hard,15,25,40,174,37.5
5525,P Moore,Clay,2,1,3,3,66.67
5526,P Mortoire,Grass,1,1,2,2,50.0
5527,P Scott,Grass,1,1,2,2,50.0
5528,Pablo Albano,Hard,2,3,5,5,40.0
5529,Pablo Andujar,Clay,105,101,206,356,50.97
5530,Pablo Andujar,Grass,2,15,17,356,11.76
5531,Pablo Andujar,Hard,38,95,133,356,28.57
5532,Pablo Arraya,Carpet,2,4,6,354,33.33
5533,Pablo Arraya,Clay,158,141,299,354,52.84
5534,Pablo Arraya,Hard,19,30,49,354,38.78
5535,Pablo Bianchi,Clay,4,5,9,9,44.44
5536,Pablo Campana,Clay,2,4,6,19,33.33
5537,Pablo Campana,Hard,9,4,13,19,69.23
5538,Pablo Carreno Busta,Clay,86,74,160,366,53.75
5539,Pablo Carreno Busta,Grass,2,8,10,366,20.0
5540,Pablo Carreno Busta,Hard,110,86,196,366,56.12
5541,Pablo Cuevas,Carpet,1,1,2,440,50.0
5542,Pablo Cuevas,Clay,161,107,268,440,60.07
5543,Pablo Cuevas,Grass,7,10,17,440,41.18
5544,Pablo Cuevas,Hard,63,90,153,440,41.18
5545,Pablo Gonzalez,Clay,5,11,16,18,31.25
5546,Pablo Gonzalez,Hard,1,1,2,18,50.0
5547,Palaphoom Kovapitukted,Hard,1,2,3,3,33.33
5548,Pancho Guzman,Clay,13,18,31,54,41.94
5549,Pancho Guzman,Grass,3,10,13,54,23.08
5550,Pancho Guzman,Hard,5,5,10,54,50.0
5551,Pancho Musalem,Clay,2,3,5,5,40.0
5552,Pancho Segura,Clay,1,1,2,16,50.0
5553,Pancho Segura,Grass,2,2,4,16,50.0
5554,Pancho Segura,Hard,3,7,10,16,30.0
5555,Pancho Walthall,Clay,2,6,8,25,25.0
5556,Pancho Walthall,Grass,4,7,11,25,36.36
5557,Pancho Walthall,Hard,2,4,6,25,33.33
5558,Panomkorn Pladchunil,Clay,2,4,6,17,33.33
5559,Panomkorn Pladchunil,Hard,5,6,11,17,45.45
5560,Paolo Bertolucci,Carpet,9,18,27,357,33.33
5561,Paolo Bertolucci,Clay,189,119,308,357,61.36
5562,Paolo Bertolucci,Grass,3,5,8,357,37.5
5563,Paolo Bertolucci,Hard,5,9,14,357,35.71
5564,Paolo Cane,Carpet,17,23,40,268,42.5
5565,Paolo Cane,Clay,94,83,177,268,53.11
5566,Paolo Cane,Grass,1,3,4,268,25.0
5567,Paolo Cane,Hard,24,23,47,268,51.06
5568,Paolo Lorenzi,Clay,60,83,143,293,41.96
5569,Paolo Lorenzi,Grass,5,20,25,293,20.0
5570,Paolo Lorenzi,Hard,45,80,125,293,36.0
5571,Paolo Pambianco,Clay,7,7,14,14,50.0
5572,Paradorn Srichaphan,Carpet,18,11,29,445,62.07
5573,Paradorn Srichaphan,Clay,12,35,47,445,25.53
5574,Paradorn Srichaphan,Grass,25,20,45,445,55.56
5575,Paradorn Srichaphan,Hard,196,128,324,445,60.49
5576,Pascal Deniau,Hard,1,1,2,2,50.0
5577,Pascal Portes,Carpet,23,27,50,227,46.0
5578,Pascal Portes,Clay,37,54,91,227,40.66
5579,Pascal Portes,Grass,4,8,12,227,33.33
5580,Pascal Portes,Hard,38,36,74,227,51.35
5581,Pascal Schaul,Clay,2,2,4,4,50.0
5582,Paschoal Penetta,Hard,1,1,2,2,50.0
5583,Pat Cash,Carpet,45,29,74,386,60.81
5584,Pat Cash,Clay,20,30,50,386,40.0
5585,Pat Cash,Grass,99,37,136,386,72.79
5586,Pat Cash,Hard,73,53,126,386,57.94
5587,Pat Cramer,Carpet,4,11,15,136,26.67
5588,Pat Cramer,Clay,11,38,49,136,22.45
5589,Pat Cramer,Grass,8,14,22,136,36.36
5590,Pat Cramer,Hard,22,28,50,136,44.0
5591,Pat Dupre,Carpet,48,56,104,382,46.15
5592,Pat Dupre,Clay,50,58,108,382,46.3
5593,Pat Dupre,Grass,23,25,48,382,47.92
5594,Pat Dupre,Hard,62,60,122,382,50.82
5595,Pat Serret,Hard,1,1,2,2,50.0
5596,Pato Rodriquez,Clay,2,1,3,3,66.67
5597,Patrice Beust,Carpet,2,2,4,42,50.0
5598,Patrice Beust,Clay,7,19,26,42,26.92
5599,Patrice Beust,Grass,5,7,12,42,41.67
5600,Patrice Dominguez,Carpet,14,18,32,328,43.75
5601,Patrice Dominguez,Clay,95,94,189,328,50.26
5602,Patrice Dominguez,Grass,30,19,49,328,61.22
5603,Patrice Dominguez,Hard,28,30,58,328,48.28
5604,Patrice Hagelauer,Grass,3,2,5,5,60.0
5605,Patrice Kuchna,Clay,7,14,21,21,33.33
5606,Patrice Wiman,Grass,1,1,2,2,50.0
5607,Patricio Arnold,Hard,1,4,5,5,20.0
5608,Patricio Cornejo,Carpet,7,18,25,320,28.0
5609,Patricio Cornejo,Clay,90,111,201,320,44.78
5610,Patricio Cornejo,Grass,14,26,40,320,35.0
5611,Patricio Cornejo,Hard,15,39,54,320,27.78
5612,Patricio Rodriguez Chi,Clay,19,35,54,62,35.19
5613,Patricio Rodriguez Chi,Grass,1,7,8,62,12.5
5614,Patrick Baur,Carpet,13,19,32,174,40.62
5615,Patrick Baur,Clay,11,26,37,174,29.73
5616,Patrick Baur,Grass,7,14,21,174,33.33
5617,Patrick Baur,Hard,36,48,84,174,42.86
5618,Patrick Chucri,Clay,4,2,6,16,66.67
5619,Patrick Chucri,Hard,3,7,10,16,30.0
5620,Patrick Hombergen,Clay,25,34,59,76,42.37
5621,Patrick Hombergen,Grass,3,8,11,76,27.27
5622,Patrick Hombergen,Hard,4,2,6,76,66.67
5623,Patrick McEnroe,Carpet,23,34,57,304,40.35
5624,Patrick McEnroe,Clay,13,22,35,304,37.14
5625,Patrick McEnroe,Grass,8,12,20,304,40.0
5626,Patrick McEnroe,Hard,96,96,192,304,50.0
5627,Patrick Proisy,Carpet,9,13,22,416,40.91
5628,Patrick Proisy,Clay,169,130,299,416,56.52
5629,Patrick Proisy,Grass,24,24,48,416,50.0
5630,Patrick Proisy,Hard,21,26,47,416,44.68
5631,Patrick Rafter,Carpet,37,26,63,551,58.73
5632,Patrick Rafter,Clay,36,34,70,551,51.43
5633,Patrick Rafter,Grass,74,25,99,551,74.75
5634,Patrick Rafter,Hard,212,107,319,551,66.46
5635,Patrick Tierro,Clay,6,5,11,16,54.55
5636,Patrick Tierro,Hard,2,3,5,16,40.0
5637,Patrik Fredriksson,Carpet,1,7,8,38,12.5
5638,Patrik Fredriksson,Clay,5,13,18,38,27.78
5639,Patrik Fredriksson,Hard,3,9,12,38,25.0
5640,Patrik Kuhnen,Carpet,36,38,74,281,48.65
5641,Patrik Kuhnen,Clay,18,28,46,281,39.13
5642,Patrik Kuhnen,Grass,19,23,42,281,45.24
5643,Patrik Kuhnen,Hard,55,64,119,281,46.22
5644,Patrik Langvardt,Clay,2,1,3,3,66.67
5645,Patrik Rosenholm,Hard,2,3,5,5,40.0
5646,Paul Annacone,Carpet,55,34,89,291,61.8
5647,Paul Annacone,Clay,7,8,15,291,46.67
5648,Paul Annacone,Grass,39,24,63,291,61.9
5649,Paul Annacone,Hard,59,65,124,291,47.58
5650,Paul Avis,Hard,3,6,9,9,33.33
5651,Paul Baccanello,Grass,1,1,2,10,50.0
5652,Paul Baccanello,Hard,1,7,8,10,12.5
5653,Paul Capdeville,Clay,21,32,53,126,39.62
5654,Paul Capdeville,Grass,3,7,10,126,30.0
5655,Paul Capdeville,Hard,24,39,63,126,38.1
5656,Paul Chamberlin,Carpet,4,11,15,124,26.67
5657,Paul Chamberlin,Grass,13,11,24,124,54.17
5658,Paul Chamberlin,Hard,40,45,85,124,47.06
5659,Paul Dogger,Clay,1,6,7,7,14.29
5660,Paul Gerken,Carpet,16,19,35,218,45.71
5661,Paul Gerken,Clay,37,43,80,218,46.25
5662,Paul Gerken,Grass,16,18,34,218,47.06
5663,Paul Gerken,Hard,36,33,69,218,52.17
5664,Paul Goldstein,Carpet,2,3,5,200,40.0
5665,Paul Goldstein,Clay,10,15,25,200,40.0
5666,Paul Goldstein,Grass,11,11,22,200,50.0
5667,Paul Goldstein,Hard,62,86,148,200,41.89
5668,Paul Haarhuis,Carpet,61,56,117,526,52.14
5669,Paul Haarhuis,Clay,65,76,141,526,46.1
5670,Paul Haarhuis,Grass,28,25,53,526,52.83
5671,Paul Haarhuis,Hard,114,101,215,526,53.02
5672,Paul Hearnden,Grass,1,1,2,4,50.0
5673,Paul Hearnden,Hard,1,1,2,4,50.0
5674,Paul Henri Mathieu,Carpet,19,14,33,584,57.58
5675,Paul Henri Mathieu,Clay,108,114,222,584,48.65
5676,Paul Henri Mathieu,Grass,22,32,54,584,40.74
5677,Paul Henri Mathieu,Hard,127,148,275,584,46.18
5678,Paul Hutchins,Clay,6,10,16,29,37.5
5679,Paul Hutchins,Grass,3,10,13,29,23.08
5680,Paul Kilderry,Carpet,2,2,4,28,50.0
5681,Paul Kilderry,Grass,2,4,6,28,33.33
5682,Paul Kilderry,Hard,4,14,18,28,22.22
5683,Paul Kronk,Carpet,6,17,23,296,26.09
5684,Paul Kronk,Clay,48,81,129,296,37.21
5685,Paul Kronk,Grass,25,32,57,296,43.86
5686,Paul Kronk,Hard,32,55,87,296,36.78
5687,Paul Mcnamee,Carpet,36,34,70,476,51.43
5688,Paul Mcnamee,Clay,112,110,222,476,50.45
5689,Paul Mcnamee,Grass,62,48,110,476,56.36
5690,Paul Mcnamee,Hard,35,39,74,476,47.3
5691,Paul Sullivan,Grass,1,5,6,6,16.67
5692,Paul Torre,Carpet,2,1,3,35,66.67
5693,Paul Torre,Clay,10,13,23,35,43.48
5694,Paul Torre,Hard,3,6,9,35,33.33
5695,Paul Van Min,Hard,1,4,5,5,20.0
5696,Paul Vojtischek,Carpet,2,4,6,58,33.33
5697,Paul Vojtischek,Clay,18,27,45,58,40.0
5698,Paul Vojtischek,Hard,2,5,7,58,28.57
5699,Paul Wekesa,Carpet,5,9,14,76,35.71
5700,Paul Wekesa,Clay,6,7,13,76,46.15
5701,Paul Wekesa,Grass,1,5,6,76,16.67
5702,Paul Wekesa,Hard,18,25,43,76,41.86
5703,Paulo Carvallo,Clay,7,4,11,15,63.64
5704,Paulo Carvallo,Hard,1,3,4,15,25.0
5705,Pavel Baranov,Hard,1,5,6,6,16.67
5706,Pavel Hutka,Carpet,2,5,7,98,28.57
5707,Pavel Hutka,Clay,32,47,79,98,40.51
5708,Pavel Hutka,Hard,4,8,12,98,33.33
5709,Pavel Slozil,Carpet,17,27,44,300,38.64
5710,Pavel Slozil,Clay,99,88,187,300,52.94
5711,Pavel Slozil,Hard,30,39,69,300,43.48
5712,Pavol Cervenak,Clay,7,4,11,11,63.64
5713,Pedja Krstin,Clay,2,1,3,3,66.67
5714,Pedro Cachin,Clay,3,4,7,7,42.86
5715,Pedro Cordeiro,Clay,5,5,10,10,50.0
5716,Pedro Langre,Clay,1,2,3,3,33.33
5717,Pedro Martinez,Clay,7,9,16,25,43.75
5718,Pedro Martinez,Hard,4,5,9,25,44.44
5719,Pedro Rebolledo,Carpet,2,3,5,224,40.0
5720,Pedro Rebolledo,Clay,103,99,202,224,50.99
5721,Pedro Rebolledo,Hard,6,11,17,224,35.29
5722,Pedro Sousa,Clay,12,17,29,39,41.38
5723,Pedro Sousa,Hard,2,8,10,39,20.0
5724,Peerakiat Siriluethaiwattana,Hard,2,5,7,7,28.57
5725,Pekka Saila,Clay,3,4,7,14,42.86
5726,Pekka Saila,Hard,1,6,7,14,14.29
5727,Pender Murphy,Clay,8,15,23,23,34.78
5728,Peng Sun,Hard,8,9,17,17,47.06
5729,Per Hegna,Clay,8,13,21,27,38.1
5730,Per Hegna,Hard,4,2,6,27,66.67
5731,Per Henricsson,Clay,2,5,7,7,28.57
5732,Per Hjertquist,Carpet,10,4,14,132,71.43
5733,Per Hjertquist,Clay,31,43,74,132,41.89
5734,Per Hjertquist,Hard,19,25,44,132,43.18
5735,Per Jemsby,Clay,4,5,9,12,44.44
5736,Per Jemsby,Hard,1,2,3,12,33.33
5737,Pere Riba,Clay,21,40,61,82,34.43
5738,Pere Riba,Hard,3,18,21,82,14.29
5739,Petar Jelenic,Hard,1,1,2,2,50.0
5740,Petar Popovic,Clay,1,1,2,2,50.0
5741,Pete Sampras,Carpet,146,50,196,996,74.49
5742,Pete Sampras,Clay,90,54,144,996,62.5
5743,Pete Sampras,Grass,102,20,122,996,83.61
5744,Pete Sampras,Hard,428,106,534,996,80.15
5745,Peter Ballauff,Clay,2,3,5,8,40.0
5746,Peter Ballauff,Hard,1,2,3,8,33.33
5747,Peter Bastiansen,Carpet,2,2,4,37,50.0
5748,Peter Bastiansen,Clay,21,12,33,37,63.64
5749,Peter Bothwell,Hard,1,1,2,2,50.0
5750,Peter Burwash,Clay,2,9,11,19,18.18
5751,Peter Burwash,Grass,2,6,8,19,25.0
5752,Peter Campbell,Grass,4,13,17,17,23.53
5753,Peter Carlsson,Carpet,1,1,2,32,50.0
5754,Peter Carlsson,Clay,2,7,9,32,22.22
5755,Peter Carlsson,Grass,3,4,7,32,42.86
5756,Peter Carlsson,Hard,4,10,14,32,28.57
5757,Peter Carter,Carpet,1,3,4,21,25.0
5758,Peter Carter,Grass,1,4,5,21,20.0
5759,Peter Carter,Hard,2,10,12,21,16.67
5760,Peter Clarke,Carpet,1,3,4,11,25.0
5761,Peter Clarke,Clay,4,3,7,11,57.14
5762,Peter Curtis,Carpet,2,5,7,75,28.57
5763,Peter Curtis,Clay,2,10,12,75,16.67
5764,Peter Curtis,Grass,15,20,35,75,42.86
5765,Peter Curtis,Hard,7,14,21,75,33.33
5766,Peter Doerner,Grass,6,13,19,35,31.58
5767,Peter Doerner,Hard,7,9,16,35,43.75
5768,Peter Doohan,Carpet,1,3,4,132,25.0
5769,Peter Doohan,Clay,3,7,10,132,30.0
5770,Peter Doohan,Grass,38,35,73,132,52.05
5771,Peter Doohan,Hard,8,37,45,132,17.78
5772,Peter Elter,Carpet,3,10,13,210,23.08
5773,Peter Elter,Clay,71,83,154,210,46.1
5774,Peter Elter,Grass,2,4,6,210,33.33
5775,Peter Elter,Hard,13,24,37,210,35.14
5776,Peter Feigl,Carpet,6,14,20,232,30.0
5777,Peter Feigl,Clay,43,41,84,232,51.19
5778,Peter Feigl,Grass,25,26,51,232,49.02
5779,Peter Feigl,Hard,38,39,77,232,49.35
5780,Peter Fishbach,Grass,1,4,5,5,20.0
5781,Peter Fleming,Carpet,90,73,163,436,55.21
5782,Peter Fleming,Clay,22,35,57,436,38.6
5783,Peter Fleming,Grass,18,27,45,436,40.0
5784,Peter Fleming,Hard,94,77,171,436,54.97
5785,Peter Gojowczyk,Clay,7,14,21,138,33.33
5786,Peter Gojowczyk,Grass,8,10,18,138,44.44
5787,Peter Gojowczyk,Hard,47,52,99,138,47.47
5788,Peter Hampton,Hard,1,2,3,3,33.33
5789,Peter Handoyo,Hard,2,3,5,5,40.0
5790,Peter Jackson,Grass,4,6,10,13,40.0
5791,Peter Jackson,Hard,1,2,3,13,33.33
5792,Peter Johnston,Clay,1,1,2,16,50.0
5793,Peter Johnston,Grass,1,7,8,16,12.5
5794,Peter Johnston,Hard,1,5,6,16,16.67
5795,Peter Kanderal,Carpet,5,3,8,33,62.5
5796,Peter Kanderal,Clay,5,10,15,33,33.33
5797,Peter Kanderal,Grass,3,4,7,33,42.86
5798,Peter Kanderal,Hard,2,1,3,33,66.67
5799,Peter Kronk,Clay,1,1,2,2,50.0
5800,Peter Lamb,Hard,1,3,4,4,25.0
5801,Peter Langsford,Grass,1,3,4,4,25.0
5802,Peter Lindgren,Carpet,3,4,7,20,42.86
5803,Peter Lindgren,Clay,1,12,13,20,7.69
5804,Peter Luczak,Clay,17,45,62,130,27.42
5805,Peter Luczak,Grass,4,5,9,130,44.44
5806,Peter Luczak,Hard,20,39,59,130,33.9
5807,Peter Lundgren,Carpet,20,28,48,255,41.67
5808,Peter Lundgren,Clay,1,18,19,255,5.26
5809,Peter Lundgren,Grass,17,17,34,255,50.0
5810,Peter Lundgren,Hard,81,73,154,255,52.6
5811,Peter Marmureanu,Clay,13,9,22,27,59.09
5812,Peter Marmureanu,Grass,1,4,5,27,20.0
5813,Peter Mcnamara,Carpet,43,21,64,343,67.19
5814,Peter Mcnamara,Clay,119,64,183,343,65.03
5815,Peter Mcnamara,Grass,25,32,57,343,43.86
5816,Peter Mcnamara,Hard,20,19,39,343,51.28
5817,Peter Moraing,Carpet,3,3,6,21,50.0
5818,Peter Moraing,Grass,1,3,4,21,25.0
5819,Peter Moraing,Hard,3,8,11,21,27.27
5820,Peter Mors,Hard,1,3,4,4,25.0
5821,Peter Nagy,Clay,3,3,6,6,50.0
5822,Peter Nyborg,Carpet,1,3,4,10,25.0
5823,Peter Nyborg,Hard,2,4,6,10,33.33
5824,Peter Palandjian,Clay,1,1,2,2,50.0
5825,Peter Pearson,Clay,2,9,11,19,18.18
5826,Peter Pearson,Hard,4,4,8,19,50.0
5827,Peter Pokorny,Clay,8,27,35,41,22.86
5828,Peter Pokorny,Hard,2,4,6,41,33.33
5829,Peter Polansky,Clay,3,10,13,57,23.08
5830,Peter Polansky,Hard,13,31,44,57,29.55
5831,Peter Rennert,Carpet,12,19,31,109,38.71
5832,Peter Rennert,Clay,6,5,11,109,54.55
5833,Peter Rennert,Grass,22,17,39,109,56.41
5834,Peter Rennert,Hard,9,19,28,109,32.14
5835,Peter Rigg,Grass,2,1,3,3,66.67
5836,Peter Smylie,Grass,1,1,2,2,50.0
5837,Peter Svensson,Clay,1,1,2,2,50.0
5838,Peter Szoke,Carpet,1,3,4,125,25.0
5839,Peter Szoke,Clay,46,53,99,125,46.46
5840,Peter Szoke,Hard,6,16,22,125,27.27
5841,Peter Tramacchi,Grass,2,4,6,18,33.33
5842,Peter Tramacchi,Hard,3,9,12,18,25.0
5843,Peter Wessels,Clay,2,7,9,100,22.22
5844,Peter Wessels,Grass,18,14,32,100,56.25
5845,Peter Wessels,Hard,25,34,59,100,42.37
5846,Peter Wright,Carpet,6,2,8,13,75.0
5847,Peter Wright,Grass,1,1,2,13,50.0
5848,Peter Wright,Hard,1,2,3,13,33.33
5849,Petr Korda,Carpet,124,70,194,664,63.92
5850,Petr Korda,Clay,90,66,156,664,57.69
5851,Petr Korda,Grass,30,16,46,664,65.22
5852,Petr Korda,Hard,169,99,268,664,63.06
5853,Petr Kralert,Hard,2,1,3,3,66.67
5854,Petr Luxa,Hard,1,11,12,12,8.33
5855,Petr Strobl,Clay,2,3,5,5,40.0
5856,Petros Chrysochos,Hard,1,3,4,4,25.0
5857,Phil Davies,Grass,1,5,6,6,16.67
5858,Phil Dent,Carpet,56,80,136,708,41.18
5859,Phil Dent,Clay,104,91,195,708,53.33
5860,Phil Dent,Grass,139,75,214,708,64.95
5861,Phil Dent,Hard,84,79,163,708,51.53
5862,Phil Lehnhoff,Clay,2,2,4,4,50.0
5863,Phil Siviter,Grass,1,2,3,3,33.33
5864,Philip Bester,Clay,1,3,4,11,25.0
5865,Philip Bester,Hard,1,6,7,11,14.29
5866,Philip Davydenko,Clay,1,1,2,2,50.0
5867,Philip Holton,Grass,2,1,3,3,66.67
5868,Philip Johnson,Clay,3,3,6,22,50.0
5869,Philip Johnson,Hard,5,11,16,22,31.25
5870,Philipp Kohlschreiber,Carpet,5,6,11,860,45.45
5871,Philipp Kohlschreiber,Clay,177,138,315,860,56.19
5872,Philipp Kohlschreiber,Grass,58,39,97,860,59.79
5873,Philipp Kohlschreiber,Hard,233,204,437,860,53.32
5874,Philipp Oswald,Clay,1,2,3,3,33.33
5875,Philipp Petzschner,Clay,16,27,43,196,37.21
5876,Philipp Petzschner,Grass,21,19,40,196,52.5
5877,Philipp Petzschner,Hard,52,61,113,196,46.02
5878,Philippe Moggio,Clay,1,4,5,5,20.0
5879,Philippe Pech,Carpet,2,2,4,15,50.0
5880,Philippe Pech,Grass,2,4,6,15,33.33
5881,Philippe Pech,Hard,1,4,5,15,20.0
5882,Phillip King,Hard,3,12,15,15,20.0
5883,Phillip Tuckniss,Clay,6,6,12,12,50.0
5884,Phillipe Ventura,Clay,1,1,2,2,50.0
5885,Photos Kallias,Clay,1,6,7,7,14.29
5886,Pichet Boratisa,Hard,1,2,3,3,33.33
5887,Pier Gauthier,Hard,1,3,4,4,25.0
5888,Pierce Kelly,Grass,1,1,2,2,50.0
5889,Piero Luisi,Clay,2,1,3,12,66.67
5890,Piero Luisi,Hard,5,4,9,12,55.56
5891,Piero Toci,Clay,10,23,33,33,30.3
5892,Pierre Barthes,Carpet,23,32,55,285,41.82
5893,Pierre Barthes,Clay,70,54,124,285,56.45
5894,Pierre Barthes,Grass,29,23,52,285,55.77
5895,Pierre Barthes,Hard,26,28,54,285,48.15
5896,Pierre Bouteyre,Grass,1,1,2,4,50.0
5897,Pierre Bouteyre,Hard,1,1,2,4,50.0
5898,Pierre Darmon,Clay,5,3,8,8,62.5
5899,Pierre Hugues Herbert,Clay,15,18,33,196,45.45
5900,Pierre Hugues Herbert,Grass,14,14,28,196,50.0
5901,Pierre Hugues Herbert,Hard,58,77,135,196,42.96
5902,Pierre Joly,Clay,1,7,8,8,12.5
5903,Pierre Ludovic Duclos,Hard,1,2,3,3,33.33
5904,Piet Norval,Hard,4,8,12,12,33.33
5905,Piet Snyman,Hard,1,1,2,2,50.0
5906,Pieter Aldrich,Carpet,3,5,8,75,37.5
5907,Pieter Aldrich,Grass,12,8,20,75,60.0
5908,Pieter Aldrich,Hard,21,26,47,75,44.68
5909,Pieter Burki,Grass,1,1,2,2,50.0
5910,Pieter Soeters,Hard,1,1,2,2,50.0
5911,Pietro Marzano,Clay,4,12,16,21,25.0
5912,Pietro Marzano,Grass,2,3,5,21,40.0
5913,Pietro Pennisi,Clay,1,3,4,4,25.0
5914,Potito Starace,Carpet,4,5,9,355,44.44
5915,Potito Starace,Clay,129,115,244,355,52.87
5916,Potito Starace,Grass,1,11,12,355,8.33
5917,Potito Starace,Hard,28,62,90,355,31.11
5918,Prajnesh Gunneswaran,Grass,2,6,8,31,25.0
5919,Prajnesh Gunneswaran,Hard,7,16,23,31,30.43
5920,Prakash Amritraj,Grass,15,8,23,50,65.22
5921,Prakash Amritraj,Hard,5,22,27,50,18.52
5922,Predrag Rusevski,Clay,5,8,13,15,38.46
5923,Predrag Rusevski,Hard,1,1,2,15,50.0
5924,Premjit Lall,Carpet,1,9,10,67,10.0
5925,Premjit Lall,Clay,4,12,16,67,25.0
5926,Premjit Lall,Grass,18,23,41,67,43.9
5927,Prima Simpatiaji,Hard,9,11,20,20,45.0
5928,Pruchya Isarow,Hard,9,5,14,14,64.29
5929,Quentin Halys,Clay,1,8,9,29,11.11
5930,Quentin Halys,Hard,5,15,20,29,25.0
5931,Quentin Pretorius,Hard,1,4,5,5,20.0
5932,Quino Munoz,Clay,4,4,8,8,50.0
5933,R Bortulan,Hard,1,1,2,2,50.0
5934,R Jenkin,Grass,1,1,2,2,50.0
5935,R W Davies,Grass,1,1,2,2,50.0
5936,R Walker,Grass,1,1,2,2,50.0
5937,Rabi Bouhassoun,Hard,1,2,3,3,33.33
5938,Rabie Chaki,Carpet,1,1,2,10,50.0
5939,Rabie Chaki,Clay,3,3,6,10,50.0
5940,Rabie Chaki,Hard,1,1,2,10,50.0
5941,Radek Stepanek,Carpet,27,19,46,690,58.7
5942,Radek Stepanek,Clay,101,83,184,690,54.89
5943,Radek Stepanek,Grass,43,30,73,690,58.9
5944,Radek Stepanek,Hard,215,172,387,690,55.56
5945,Radomir Vasek,Carpet,1,9,10,60,10.0
5946,Radomir Vasek,Clay,8,19,27,60,29.63
5947,Radomir Vasek,Grass,1,2,3,60,33.33
5948,Radomir Vasek,Hard,10,10,20,60,50.0
5949,Radoslav Lukaev,Carpet,1,1,2,8,50.0
5950,Radoslav Lukaev,Clay,2,2,4,8,50.0
5951,Radoslav Lukaev,Hard,1,1,2,8,50.0
5952,Radoslaw Nijaki,Clay,1,1,2,2,50.0
5953,Radu Albot,Clay,22,29,51,188,43.14
5954,Radu Albot,Grass,7,7,14,188,50.0
5955,Radu Albot,Hard,52,71,123,188,42.28
5956,Raemon Sluiter,Carpet,9,15,24,221,37.5
5957,Raemon Sluiter,Clay,24,38,62,221,38.71
5958,Raemon Sluiter,Grass,23,26,49,221,46.94
5959,Raemon Sluiter,Hard,34,52,86,221,39.53
5960,Rafael Arevalo,Clay,7,5,12,26,58.33
5961,Rafael Arevalo,Hard,6,8,14,26,42.86
5962,Rafael Avalos Brenes,Hard,4,6,10,10,40.0
5963,Rafael Jordan,Hard,2,3,5,5,40.0
5964,Rafael Moreno,Clay,9,7,16,16,56.25
5965,Rafael Nadal,Carpet,2,6,8,1226,25.0
5966,Rafael Nadal,Clay,449,42,491,1226,91.45
5967,Rafael Nadal,Grass,71,20,91,1226,78.02
5968,Rafael Nadal,Hard,494,142,636,1226,77.67
5969,Rafael Ruiz,Clay,4,8,12,12,33.33
5970,Rainer Eitzinger,Clay,3,4,7,10,42.86
5971,Rainer Eitzinger,Hard,1,2,3,10,33.33
5972,Rainer Schuettler,Carpet,23,26,49,668,46.94
5973,Rainer Schuettler,Clay,64,99,163,668,39.26
5974,Rainer Schuettler,Grass,45,36,81,668,55.56
5975,Rainer Schuettler,Hard,197,178,375,668,52.53
5976,Rajeev Ram,Clay,4,7,11,151,36.36
5977,Rajeev Ram,Grass,19,16,35,151,54.29
5978,Rajeev Ram,Hard,34,71,105,151,32.38
5979,Ralph Kok,Carpet,1,2,3,3,33.33
5980,Ralph Sender,Hard,1,2,3,3,33.33
5981,Ramanathan Krishnan,Clay,3,4,7,12,42.86
5982,Ramanathan Krishnan,Grass,1,2,3,12,33.33
5983,Ramanathan Krishnan,Hard,1,1,2,12,50.0
5984,Ramayah Ramachandran,Hard,5,9,14,14,35.71
5985,Ramesh Krishnan,Carpet,48,45,93,614,51.61
5986,Ramesh Krishnan,Clay,44,68,112,614,39.29
5987,Ramesh Krishnan,Grass,57,47,104,614,54.81
5988,Ramesh Krishnan,Hard,174,131,305,614,57.05
5989,Ramin Raziyani,Clay,5,6,11,21,45.45
5990,Ramin Raziyani,Hard,4,6,10,21,40.0
5991,Ramiro Benavides,Clay,41,87,128,141,32.03
5992,Ramiro Benavides,Hard,3,10,13,141,23.08
5993,Ramiro Gonzalo Benavides Saravia,Clay,2,2,4,4,50.0
5994,Ramkumar Ramanathan,Grass,8,5,13,46,61.54
5995,Ramkumar Ramanathan,Hard,11,22,33,46,33.33
5996,Ramon Delgado,Carpet,3,3,6,219,50.0
5997,Ramon Delgado,Clay,52,31,83,219,62.65
5998,Ramon Delgado,Grass,2,9,11,219,18.18
5999,Ramon Delgado,Hard,51,68,119,219,42.86
6000,Rand Evett,Carpet,1,1,2,16,50.0
6001,Rand Evett,Grass,2,6,8,16,25.0
6002,Rand Evett,Hard,2,4,6,16,33.33
6003,Randy Crawford,Carpet,4,3,7,17,57.14
6004,Randy Crawford,Hard,3,7,10,17,30.0
6005,Randy Nixon,Grass,1,2,3,3,33.33
6006,Rashid Hassan,Hard,1,2,3,3,33.33
6007,Rashid Malik,Clay,3,3,6,18,50.0
6008,Rashid Malik,Hard,7,5,12,18,58.33
6009,Rasid Winklaar,Hard,2,3,5,5,40.0
6010,Rasmus Norby,Hard,1,2,3,3,33.33
6011,Raul Antonio Viver,Carpet,1,3,4,93,25.0
6012,Raul Antonio Viver,Clay,33,50,83,93,39.76
6013,Raul Antonio Viver,Hard,1,5,6,93,16.67
6014,Raul Peralta,Clay,5,6,11,11,45.45
6015,Raul Ramirez,Carpet,85,59,144,809,59.03
6016,Raul Ramirez,Clay,234,88,322,809,72.67
6017,Raul Ramirez,Grass,49,26,75,809,65.33
6018,Raul Ramirez,Hard,177,91,268,809,66.04
6019,Rauty Krog,Clay,2,4,6,35,33.33
6020,Rauty Krog,Grass,3,5,8,35,37.5
6021,Rauty Krog,Hard,7,14,21,35,33.33
6022,Raven Klaasen,Grass,2,1,3,12,66.67
6023,Raven Klaasen,Hard,5,4,9,12,55.56
6024,Raviv Weidenfeld,Hard,3,6,9,9,33.33
6025,Ray Keldie,Clay,10,25,35,116,28.57
6026,Ray Keldie,Grass,21,31,52,116,40.38
6027,Ray Keldie,Hard,7,22,29,116,24.14
6028,Ray Kelly,Clay,1,1,2,8,50.0
6029,Ray Kelly,Grass,1,5,6,8,16.67
6030,Ray Ruffels,Carpet,21,35,56,358,37.5
6031,Ray Ruffels,Clay,45,39,84,358,53.57
6032,Ray Ruffels,Grass,70,51,121,358,57.85
6033,Ray Ruffels,Hard,46,51,97,358,47.42
6034,Raymond Moore,Carpet,54,70,124,650,43.55
6035,Raymond Moore,Clay,82,104,186,650,44.09
6036,Raymond Moore,Grass,48,49,97,650,49.48
6037,Raymond Moore,Hard,129,114,243,650,53.09
6038,Raymond Suarez,Clay,1,2,3,3,33.33
6039,Rayno Seegers,Clay,1,4,5,21,20.0
6040,Rayno Seegers,Grass,3,6,9,21,33.33
6041,Rayno Seegers,Hard,1,6,7,21,14.29
6042,Razlan Rawi,Hard,1,3,4,4,25.0
6043,Razvan Sabau,Clay,17,30,47,74,36.17
6044,Razvan Sabau,Grass,3,4,7,74,42.86
6045,Razvan Sabau,Hard,5,15,20,74,25.0
6046,Reda El Amrani,Clay,7,6,13,13,53.85
6047,Reda Galou,Clay,4,2,6,10,66.67
6048,Reda Galou,Hard,3,1,4,10,75.0
6049,Reginald Bennett,Grass,1,1,2,2,50.0
6050,Reginald Willems,Clay,1,1,2,2,50.0
6051,Regis Brunet,Carpet,1,2,3,8,33.33
6052,Regis Brunet,Clay,1,4,5,8,20.0
6053,Reijo Tuomola,Grass,1,1,2,2,50.0
6054,Reilly Opelka,Clay,2,9,11,97,18.18
6055,Reilly Opelka,Grass,2,3,5,97,40.0
6056,Reilly Opelka,Hard,45,36,81,97,55.56
6057,Reinhard Mattern,Clay,3,3,6,6,50.0
6058,Reinhart Probst,Clay,3,3,6,15,50.0
6059,Reinhart Probst,Hard,5,4,9,15,55.56
6060,Rejean Genois,Carpet,3,6,9,43,33.33
6061,Rejean Genois,Clay,5,15,20,43,25.0
6062,Rejean Genois,Hard,8,6,14,43,57.14
6063,Remzi Aydin,Clay,2,2,4,4,50.0
6064,Rene Busch,Clay,2,2,4,4,50.0
6065,Renzo Furlan,Carpet,32,33,65,466,49.23
6066,Renzo Furlan,Clay,134,135,269,466,49.81
6067,Renzo Furlan,Grass,3,6,9,466,33.33
6068,Renzo Furlan,Hard,55,68,123,466,44.72
6069,Renzo Olivo,Clay,21,23,44,52,47.73
6070,Renzo Olivo,Hard,2,6,8,52,25.0
6071,Rhyne Williams,Clay,3,3,6,23,50.0
6072,Rhyne Williams,Hard,4,13,17,23,23.53
6073,Ricardas Berankis,Clay,8,21,29,233,27.59
6074,Ricardas Berankis,Grass,4,15,19,233,21.05
6075,Ricardas Berankis,Hard,97,88,185,233,52.43
6076,Ricardo Acioly,Carpet,1,1,2,9,50.0
6077,Ricardo Acioly,Grass,1,1,2,9,50.0
6078,Ricardo Acioly,Hard,1,4,5,9,20.0
6079,Ricardo Acuna,Carpet,7,11,18,187,38.89
6080,Ricardo Acuna,Clay,21,44,65,187,32.31
6081,Ricardo Acuna,Grass,22,20,42,187,52.38
6082,Ricardo Acuna,Hard,24,38,62,187,38.71
6083,Ricardo Aubone,Clay,2,2,4,4,50.0
6084,Ricardo Camargo,Hard,1,1,2,2,50.0
6085,Ricardo Cano,Carpet,4,6,10,310,40.0
6086,Ricardo Cano,Clay,141,142,283,310,49.82
6087,Ricardo Cano,Hard,8,9,17,310,47.06
6088,Ricardo Chile Fonte,Clay,1,3,4,14,25.0
6089,Ricardo Chile Fonte,Hard,6,4,10,14,60.0
6090,Ricardo Gonzalez Diaz,Hard,1,3,4,4,25.0
6091,Ricardo Mello,Clay,26,31,57,150,45.61
6092,Ricardo Mello,Grass,1,8,9,150,11.11
6093,Ricardo Mello,Hard,33,51,84,150,39.29
6094,Ricardo Mena,Clay,13,12,25,30,52.0
6095,Ricardo Mena,Hard,2,3,5,30,40.0
6096,Ricardo Ojeda Lara,Clay,1,2,3,6,33.33
6097,Ricardo Ojeda Lara,Hard,2,1,3,6,66.67
6098,Ricardo Rodriguez,Clay,3,3,6,27,50.0
6099,Ricardo Rodriguez,Hard,16,5,21,27,76.19
6100,Ricardo Ycaza,Carpet,3,12,15,181,20.0
6101,Ricardo Ycaza,Clay,73,78,151,181,48.34
6102,Ricardo Ycaza,Grass,1,4,5,181,20.0
6103,Ricardo Ycaza,Hard,1,9,10,181,10.0
6104,Richard Ashby,Clay,6,8,14,18,42.86
6105,Richard Ashby,Hard,2,2,4,18,50.0
6106,Richard Bloomfield,Grass,4,10,14,14,28.57
6107,Richard Coulthard,Grass,1,1,2,2,50.0
6108,Richard Fromberg,Carpet,8,27,35,546,22.86
6109,Richard Fromberg,Clay,130,127,257,546,50.58
6110,Richard Fromberg,Grass,17,21,38,546,44.74
6111,Richard Fromberg,Hard,103,113,216,546,47.69
6112,Richard Gallien,Hard,1,1,2,2,50.0
6113,Richard Gasquet,Carpet,9,8,17,887,52.94
6114,Richard Gasquet,Clay,142,89,231,887,61.47
6115,Richard Gasquet,Grass,70,35,105,887,66.67
6116,Richard Gasquet,Hard,328,206,534,887,61.42
6117,Richard Hawkes,Grass,1,6,7,16,14.29
6118,Richard Hawkes,Hard,3,6,9,16,33.33
6119,Richard Howes,Grass,1,1,2,2,50.0
6120,Richard Krajicek,Carpet,82,47,129,635,63.57
6121,Richard Krajicek,Clay,79,53,132,635,59.85
6122,Richard Krajicek,Grass,63,26,89,635,70.79
6123,Richard Krajicek,Hard,190,95,285,635,66.67
6124,Richard Laver,Carpet,2,1,3,3,66.67
6125,Richard Leach,Grass,3,2,5,5,60.0
6126,Richard Lewis,Carpet,8,19,27,189,29.63
6127,Richard Lewis,Clay,15,38,53,189,28.3
6128,Richard Lewis,Grass,29,42,71,189,40.85
6129,Richard Lewis,Hard,18,20,38,189,47.37
6130,Richard Matuszewski,Carpet,10,14,24,134,41.67
6131,Richard Matuszewski,Clay,1,3,4,134,25.0
6132,Richard Matuszewski,Grass,9,15,24,134,37.5
6133,Richard Matuszewski,Hard,34,48,82,134,41.46
6134,Richard Meyer,Carpet,17,24,41,119,41.46
6135,Richard Meyer,Clay,7,18,25,119,28.0
6136,Richard Meyer,Grass,9,13,22,119,40.91
6137,Richard Meyer,Hard,9,22,31,119,29.03
6138,Richard Pancho Gonzales,Carpet,16,12,28,170,57.14
6139,Richard Pancho Gonzales,Clay,12,7,19,170,63.16
6140,Richard Pancho Gonzales,Grass,31,16,47,170,65.96
6141,Richard Pancho Gonzales,Hard,59,17,76,170,77.63
6142,Richard Russell,Carpet,2,4,6,53,33.33
6143,Richard Russell,Clay,3,12,15,53,20.0
6144,Richard Russell,Grass,2,2,4,53,50.0
6145,Richard Russell,Hard,12,16,28,53,42.86
6146,Richard Schmidt,Hard,1,10,11,11,9.09
6147,Richard Vogel,Clay,3,8,11,11,27.27
6148,Richey Reneberg,Carpet,52,50,102,572,50.98
6149,Richey Reneberg,Clay,46,44,90,572,51.11
6150,Richey Reneberg,Grass,39,29,68,572,57.35
6151,Richey Reneberg,Hard,172,140,312,572,55.13
6152,Rick Fagel,Carpet,1,7,8,143,12.5
6153,Rick Fagel,Clay,37,69,106,143,34.91
6154,Rick Fagel,Hard,9,20,29,143,31.03
6155,Rick Fisher,Carpet,9,20,29,143,31.03
6156,Rick Fisher,Clay,9,30,39,143,23.08
6157,Rick Fisher,Grass,9,16,25,143,36.0
6158,Rick Fisher,Hard,15,35,50,143,30.0
6159,Rick Jordan,Grass,1,1,2,2,50.0
6160,Rick Leach,Carpet,6,14,20,72,30.0
6161,Rick Leach,Grass,1,6,7,72,14.29
6162,Rick Leach,Hard,14,31,45,72,31.11
6163,Rick Meyers,Hard,1,2,3,3,33.33
6164,Rick Rozen,Hard,1,1,2,2,50.0
6165,Rick Rudeen,Hard,3,5,8,8,37.5
6166,Ricki Osterthun,Carpet,4,8,12,131,33.33
6167,Ricki Osterthun,Clay,46,46,92,131,50.0
6168,Ricki Osterthun,Hard,10,17,27,131,37.04
6169,Ricky Brown,Grass,1,1,2,13,50.0
6170,Ricky Brown,Hard,3,8,11,13,27.27
6171,Ricky Buwalda,Grass,1,1,2,8,50.0
6172,Ricky Buwalda,Hard,2,4,6,8,33.33
6173,Ricky Morea,Clay,1,1,2,2,50.0
6174,Rik De Voest,Clay,2,7,9,86,22.22
6175,Rik De Voest,Grass,3,8,11,86,27.27
6176,Rik De Voest,Hard,28,38,66,86,42.42
6177,Rikard Bergh,Carpet,2,3,5,12,40.0
6178,Rikard Bergh,Hard,1,6,7,12,14.29
6179,Rob Kilderry,Grass,1,1,2,2,50.0
6180,Rob Steckley,Clay,1,1,2,2,50.0
6181,Robbie Koenig,Grass,1,2,3,13,33.33
6182,Robbie Koenig,Hard,2,8,10,13,20.0
6183,Robbie Venter,Clay,5,11,16,25,31.25
6184,Robbie Venter,Hard,2,7,9,25,22.22
6185,Robbie Weiss,Carpet,9,10,19,127,47.37
6186,Robbie Weiss,Clay,1,10,11,127,9.09
6187,Robbie Weiss,Grass,5,7,12,127,41.67
6188,Robbie Weiss,Hard,33,52,85,127,38.82
6189,Robby Ginepri,Carpet,8,8,16,393,50.0
6190,Robby Ginepri,Clay,14,35,49,393,28.57
6191,Robby Ginepri,Grass,24,26,50,393,48.0
6192,Robby Ginepri,Hard,143,135,278,393,51.44
6193,Robert Angelo,Clay,2,3,5,5,40.0
6194,Robert Bettauer,Hard,1,3,4,4,25.0
6195,Robert Casey C100,Grass,1,6,7,7,14.29
6196,Robert Collins,Carpet,1,1,2,2,50.0
6197,Robert Dolan,Carpet,3,1,4,4,75.0
6198,Robert Farah,Clay,4,6,10,10,40.0
6199,Robert Kendrick,Clay,2,10,12,113,16.67
6200,Robert Kendrick,Grass,4,14,18,113,22.22
6201,Robert Kendrick,Hard,29,54,83,113,34.94
6202,Robert Kreiss,Carpet,10,11,21,78,47.62
6203,Robert Kreiss,Clay,3,14,17,78,17.65
6204,Robert Kreiss,Grass,2,10,12,78,16.67
6205,Robert Kreiss,Hard,9,19,28,78,32.14
6206,Robert Lutz,Carpet,127,82,209,668,60.77
6207,Robert Lutz,Clay,59,51,110,668,53.64
6208,Robert Lutz,Grass,66,37,103,668,64.08
6209,Robert Lutz,Hard,148,98,246,668,60.16
6210,Robert Machan,Carpet,3,5,8,58,37.5
6211,Robert Machan,Clay,13,27,40,58,32.5
6212,Robert Machan,Grass,2,3,5,58,40.0
6213,Robert Machan,Hard,2,3,5,58,40.0
6214,Robert Maud,Carpet,13,31,44,200,29.55
6215,Robert Maud,Clay,28,31,59,200,47.46
6216,Robert Maud,Grass,19,20,39,200,48.72
6217,Robert Maud,Hard,23,35,58,200,39.66
6218,Robert Mckinley,Clay,2,13,15,54,13.33
6219,Robert Mckinley,Grass,14,12,26,54,53.85
6220,Robert Mckinley,Hard,6,7,13,54,46.15
6221,Robert Millington,Hard,1,1,2,2,50.0
6222,Robert Morrison,Hard,1,1,2,2,50.0
6223,Robert Reininger,Carpet,1,6,7,50,14.29
6224,Robert Reininger,Clay,7,19,26,50,26.92
6225,Robert Reininger,Hard,7,10,17,50,41.18
6226,Robert Rheinberger,Clay,3,20,23,23,13.04
6227,Robert Seguso,Carpet,12,13,25,179,48.0
6228,Robert Seguso,Clay,3,10,13,179,23.08
6229,Robert Seguso,Grass,20,17,37,179,54.05
6230,Robert Seguso,Hard,53,51,104,179,50.96
6231,Robert Sherman,Clay,1,1,2,2,50.0
6232,Robert Smeets,Hard,1,7,8,8,12.5
6233,Robert Stock,Clay,1,3,4,9,25.0
6234,Robert Stock,Grass,1,4,5,9,20.0
6235,Robert Trogolo,Carpet,2,4,6,24,33.33
6236,Robert Trogolo,Clay,1,2,3,24,33.33
6237,Robert Trogolo,Grass,1,3,4,24,25.0
6238,Robert Trogolo,Hard,5,6,11,24,45.45
6239,Robert Vant Hof,Carpet,18,27,45,188,40.0
6240,Robert Vant Hof,Clay,9,18,27,188,33.33
6241,Robert Vant Hof,Grass,8,14,22,188,36.36
6242,Robert Vant Hof,Hard,48,46,94,188,51.06
6243,Robert Wilson,Clay,6,5,11,30,54.55
6244,Robert Wilson,Grass,8,11,19,30,42.11
6245,Roberto Arguello,Carpet,1,2,3,145,33.33
6246,Roberto Arguello,Clay,58,76,134,145,43.28
6247,Roberto Arguello,Hard,2,6,8,145,25.0
6248,Roberto Aubone,Clay,4,5,9,9,44.44
6249,Roberto Azar,Clay,48,75,123,134,39.02
6250,Roberto Azar,Hard,1,10,11,134,9.09
6251,Roberto Bautista Agut,Clay,76,52,128,499,59.38
6252,Roberto Bautista Agut,Grass,32,13,45,499,71.11
6253,Roberto Bautista Agut,Hard,206,120,326,499,63.19
6254,Roberto Carballes Baena,Clay,43,43,86,119,50.0
6255,Roberto Carballes Baena,Grass,1,5,6,119,16.67
6256,Roberto Carballes Baena,Hard,10,17,27,119,37.04
6257,Roberto Carretero,Clay,22,40,62,67,35.48
6258,Roberto Carretero,Hard,1,4,5,67,20.0
6259,Roberto Chavez,Carpet,2,3,5,15,40.0
6260,Roberto Chavez,Clay,2,6,8,15,25.0
6261,Roberto Chavez,Grass,1,1,2,15,50.0
6262,Roberto Cid,Clay,1,5,6,13,16.67
6263,Roberto Cid,Hard,2,5,7,13,28.57
6264,Roberto Jabali,Carpet,2,2,4,34,50.0
6265,Roberto Jabali,Clay,7,9,16,34,43.75
6266,Roberto Jabali,Hard,3,11,14,34,21.43
6267,Roberto Lombardi,Clay,2,13,15,15,13.33
6268,Roberto Marcora,Hard,3,2,5,5,60.0
6269,Roberto Quiroz,Clay,3,3,6,13,50.0
6270,Roberto Quiroz,Hard,4,3,7,13,57.14
6271,Roberto Saad,Clay,4,6,10,42,40.0
6272,Roberto Saad,Grass,4,8,12,42,33.33
6273,Roberto Saad,Hard,5,15,20,42,25.0
6274,Roberto Saya,Clay,1,2,3,3,33.33
6275,Roberto Vizcaino,Clay,20,30,50,54,40.0
6276,Roberto Vizcaino,Hard,1,3,4,54,25.0
6277,Robin Drysdale,Carpet,5,6,11,115,45.45
6278,Robin Drysdale,Clay,16,31,47,115,34.04
6279,Robin Drysdale,Grass,9,27,36,115,25.0
6280,Robin Drysdale,Hard,7,14,21,115,33.33
6281,Robin Haase,Carpet,1,1,2,497,50.0
6282,Robin Haase,Clay,87,85,172,497,50.58
6283,Robin Haase,Grass,22,33,55,497,40.0
6284,Robin Haase,Hard,118,150,268,497,44.03
6285,Robin Ray,Hard,1,1,2,2,50.0
6286,Robin Soderling,Carpet,22,6,28,482,78.57
6287,Robin Soderling,Clay,86,52,138,482,62.32
6288,Robin Soderling,Grass,26,17,43,482,60.47
6289,Robin Soderling,Hard,176,97,273,482,64.47
6290,Robin Vik,Carpet,4,5,9,58,44.44
6291,Robin Vik,Clay,9,14,23,58,39.13
6292,Robin Vik,Grass,1,4,5,58,20.0
6293,Robin Vik,Hard,6,15,21,58,28.57
6294,Robinson Ureta,Hard,3,5,8,8,37.5
6295,Rocky Royer,Carpet,2,2,4,11,50.0
6296,Rocky Royer,Clay,1,6,7,11,14.29
6297,Rod Brent,Grass,3,4,7,7,42.86
6298,Rod Frawley,Carpet,15,29,44,243,34.09
6299,Rod Frawley,Clay,18,30,48,243,37.5
6300,Rod Frawley,Grass,50,44,94,243,53.19
6301,Rod Frawley,Hard,24,33,57,243,42.11
6302,Rod Laver,Carpet,137,41,178,586,76.97
6303,Rod Laver,Clay,101,29,130,586,77.69
6304,Rod Laver,Grass,81,15,96,586,84.38
6305,Rod Laver,Hard,151,31,182,586,82.97
6306,Rodney Harmon,Clay,7,11,18,73,38.89
6307,Rodney Harmon,Grass,8,11,19,73,42.11
6308,Rodney Harmon,Hard,19,17,36,73,52.78
6309,Rodney Mandelstam,Clay,1,1,2,2,50.0
6310,Rodolphe Cadart,Clay,1,2,3,7,33.33
6311,Rodolphe Cadart,Hard,2,2,4,7,50.0
6312,Rodolphe Gilbert,Carpet,8,14,22,183,36.36
6313,Rodolphe Gilbert,Clay,27,45,72,183,37.5
6314,Rodolphe Gilbert,Grass,2,9,11,183,18.18
6315,Rodolphe Gilbert,Hard,30,48,78,183,38.46
6316,Rodrigo Arus,Hard,1,1,2,2,50.0
6317,Rodrigo Navarro,Clay,1,1,2,2,50.0
6318,Rodrigo Rafael,Clay,2,1,3,6,66.67
6319,Rodrigo Rafael,Hard,1,2,3,6,33.33
6320,Rodrigo Senattore,Hard,1,1,2,2,50.0
6321,Roger Dowdeswell,Carpet,4,6,10,47,40.0
6322,Roger Dowdeswell,Clay,6,16,22,47,27.27
6323,Roger Dowdeswell,Grass,2,6,8,47,25.0
6324,Roger Dowdeswell,Hard,2,5,7,47,28.57
6325,Roger Federer,Carpet,50,19,69,1524,72.46
6326,Roger Federer,Clay,224,71,295,1524,75.93
6327,Roger Federer,Grass,189,27,216,1524,87.5
6328,Roger Federer,Hard,786,158,944,1524,83.26
6329,Roger Guedes,Clay,4,11,15,18,26.67
6330,Roger Guedes,Hard,1,2,3,18,33.33
6331,Roger Knapp,Grass,4,3,7,7,57.14
6332,Roger Mckee,Clay,1,1,2,2,50.0
6333,Roger Rasheed,Hard,5,5,10,10,50.0
6334,Roger Smith,Carpet,4,6,10,116,40.0
6335,Roger Smith,Clay,7,15,22,116,31.82
6336,Roger Smith,Grass,4,5,9,116,44.44
6337,Roger Smith,Hard,32,43,75,116,42.67
6338,Roger Taylor,Carpet,87,61,148,554,58.78
6339,Roger Taylor,Clay,88,68,156,554,56.41
6340,Roger Taylor,Grass,78,46,124,554,62.9
6341,Roger Taylor,Hard,72,54,126,554,57.14
6342,Rogerio Dutra Silva,Clay,22,40,62,90,35.48
6343,Rogerio Dutra Silva,Hard,8,20,28,90,28.57
6344,Rogier Wassen,Clay,1,4,5,12,20.0
6345,Rogier Wassen,Hard,3,4,7,12,42.86
6346,Rohan Bopanna,Grass,8,10,18,47,44.44
6347,Rohan Bopanna,Hard,6,23,29,47,20.69
6348,Rohan De Silva,Clay,5,5,10,17,50.0
6349,Rohan De Silva,Grass,1,1,2,17,50.0
6350,Rohan De Silva,Hard,3,2,5,17,60.0
6351,Rohan Summers,Hard,3,6,9,9,33.33
6352,Rohun Beven,Grass,1,2,3,7,33.33
6353,Rohun Beven,Hard,1,3,4,7,25.0
6354,Rok Jarc,Clay,1,1,2,2,50.0
6355,Roko Karanusic,Clay,2,10,12,55,16.67
6356,Roko Karanusic,Grass,4,8,12,55,33.33
6357,Roko Karanusic,Hard,8,23,31,55,25.81
6358,Roland Burtscher,Clay,1,3,4,7,25.0
6359,Roland Burtscher,Hard,1,2,3,7,33.33
6360,Roland So,Carpet,2,2,4,14,50.0
6361,Roland So,Clay,1,3,4,14,25.0
6362,Roland So,Hard,3,3,6,14,50.0
6363,Roland Stadler,Carpet,8,10,18,151,44.44
6364,Roland Stadler,Clay,46,55,101,151,45.54
6365,Roland Stadler,Hard,11,21,32,151,34.38
6366,Roland Steigler,Carpet,2,2,4,4,50.0
6367,Rolandas Murashka,Carpet,3,3,6,12,50.0
6368,Rolandas Murashka,Clay,3,1,4,12,75.0
6369,Rolandas Murashka,Hard,1,1,2,12,50.0
6370,Rolf Gehring,Carpet,8,17,25,264,32.0
6371,Rolf Gehring,Clay,79,83,162,264,48.77
6372,Rolf Gehring,Grass,11,12,23,264,47.83
6373,Rolf Gehring,Hard,22,32,54,264,40.74
6374,Rolf Hertzog,Clay,1,3,4,4,25.0
6375,Rolf Norberg,Carpet,2,4,6,74,33.33
6376,Rolf Norberg,Clay,16,32,48,74,33.33
6377,Rolf Norberg,Hard,9,11,20,74,45.0
6378,Rolf Thung,Carpet,7,11,18,92,38.89
6379,Rolf Thung,Clay,9,34,43,92,20.93
6380,Rolf Thung,Grass,4,10,14,92,28.57
6381,Rolf Thung,Hard,4,13,17,92,23.53
6382,Romain Arneodo,Clay,2,1,3,6,66.67
6383,Romain Arneodo,Hard,2,1,3,6,66.67
6384,Romain Jouan,Hard,1,3,4,4,25.0
6385,Roman Recarte,Clay,2,2,4,7,50.0
6386,Roman Recarte,Hard,1,2,3,7,33.33
6387,Roman Safiullin,Hard,2,4,6,6,33.33
6388,Romano Tatuhey,Hard,3,1,4,4,75.0
6389,Romeo Rafon,Clay,3,2,5,5,60.0
6390,Ron Bohrnstedt,Clay,1,1,2,2,50.0
6391,Ron Goldman,Grass,1,3,4,4,25.0
6392,Ron Hightower,Carpet,1,2,3,24,33.33
6393,Ron Hightower,Grass,2,8,10,24,20.0
6394,Ron Hightower,Hard,4,7,11,24,36.36
6395,Ron Holmberg,Carpet,1,8,9,62,11.11
6396,Ron Holmberg,Clay,5,7,12,62,41.67
6397,Ron Holmberg,Grass,11,13,24,62,45.83
6398,Ron Holmberg,Hard,5,12,17,62,29.41
6399,Ronald Agenor,Carpet,32,41,73,484,43.84
6400,Ronald Agenor,Clay,146,133,279,484,52.33
6401,Ronald Agenor,Grass,3,6,9,484,33.33
6402,Ronald Agenor,Hard,46,77,123,484,37.4
6403,Ronan Fearon,Grass,1,4,5,5,20.0
6404,Ronnie Bathman,Carpet,1,1,2,35,50.0
6405,Ronnie Bathman,Clay,4,15,19,35,21.05
6406,Ronnie Bathman,Grass,1,3,4,35,25.0
6407,Ronnie Bathman,Hard,3,7,10,35,30.0
6408,Rory Chappell,Clay,4,6,10,20,40.0
6409,Rory Chappell,Hard,4,6,10,20,40.0
6410,Roscoe Tanner,Carpet,160,86,246,875,65.04
6411,Roscoe Tanner,Clay,97,57,154,875,62.99
6412,Roscoe Tanner,Grass,116,42,158,875,73.42
6413,Roscoe Tanner,Hard,214,103,317,875,67.51
6414,Ross Case,Carpet,36,53,89,520,40.45
6415,Ross Case,Clay,58,64,122,520,47.54
6416,Ross Case,Grass,78,61,139,520,56.12
6417,Ross Case,Hard,85,85,170,520,50.0
6418,Ross Matheson,Grass,1,4,5,5,20.0
6419,Roy Barth,Carpet,1,27,28,149,3.57
6420,Roy Barth,Clay,5,24,29,149,17.24
6421,Roy Barth,Grass,16,21,37,149,43.24
6422,Roy Barth,Hard,12,43,55,149,21.82
6423,Roy Emerson,Carpet,60,39,99,333,60.61
6424,Roy Emerson,Clay,50,27,77,333,64.94
6425,Roy Emerson,Grass,40,19,59,333,67.8
6426,Roy Emerson,Hard,57,41,98,333,58.16
6427,Roy Schwegman,Hard,1,2,3,3,33.33
6428,Royce Deppe,Hard,1,3,4,4,25.0
6429,Ruan Kruger,Hard,1,1,2,2,50.0
6430,Ruan Roelofse,Hard,2,6,8,8,25.0
6431,Ruben Alvarenga,Clay,1,10,11,11,9.09
6432,Ruben Bemelmans,Clay,3,6,9,86,33.33
6433,Ruben Bemelmans,Grass,6,14,20,86,30.0
6434,Ruben Bemelmans,Hard,19,38,57,86,33.33
6435,Ruben Gajardo,Clay,1,3,4,4,25.0
6436,Ruben Gonzales,Clay,7,2,9,9,77.78
6437,Ruben Porges,Grass,2,1,3,3,66.67
6438,Ruben Ramirez Hidalgo,Clay,61,94,155,191,39.35
6439,Ruben Ramirez Hidalgo,Hard,7,29,36,191,19.44
6440,Ruby Hoskowetz,Clay,2,5,7,7,28.57
6441,Rudiger Haas,Carpet,1,1,2,2,50.0
6442,Rudolf Molleker,Clay,3,5,8,12,37.5
6443,Rudolf Molleker,Grass,1,3,4,12,25.0
6444,Rudy Foo,Carpet,1,1,2,2,50.0
6445,Rudy Hernando,Clay,3,5,8,8,37.5
6446,Rui Machado,Clay,24,32,56,79,42.86
6447,Rui Machado,Hard,5,18,23,79,21.74
6448,Ruslon Rainov,Clay,3,2,5,5,60.0
6449,Russell Barlow,Carpet,2,3,5,10,40.0
6450,Russell Barlow,Hard,1,4,5,10,20.0
6451,Russell Simpson,Carpet,11,30,41,351,26.83
6452,Russell Simpson,Clay,15,37,52,351,28.85
6453,Russell Simpson,Grass,56,61,117,351,47.86
6454,Russell Simpson,Hard,62,79,141,351,43.97
6455,Ryan Harrison,Clay,15,27,42,279,35.71
6456,Ryan Harrison,Grass,13,24,37,279,35.14
6457,Ryan Harrison,Hard,92,108,200,279,46.0
6458,Ryan Moore2,Carpet,1,1,2,2,50.0
6459,Ryan Russell,Hard,8,3,11,11,72.73
6460,Ryan Sweeting,Clay,8,7,15,92,53.33
6461,Ryan Sweeting,Grass,3,7,10,92,30.0
6462,Ryan Sweeting,Hard,24,43,67,92,35.82
6463,Ryler Deheart,Hard,1,4,5,5,20.0
6464,Ryuso Tsujino,Carpet,2,4,6,6,33.33
6465,S Fine,Grass,1,1,2,2,50.0
6466,S Hegna,Clay,3,1,4,4,75.0
6467,S Johansson,Clay,1,1,2,2,50.0
6468,S Joseph,Grass,1,1,2,2,50.0
6469,S Sullivan,Hard,1,1,2,2,50.0
6470,S Viljoen,Hard,1,1,2,2,50.0
6471,Sacha Thoma,Carpet,1,3,4,4,25.0
6472,Sachio Kato,Clay,1,8,9,9,11.11
6473,Sadiq Abdullahi,Clay,1,4,5,8,20.0
6474,Sadiq Abdullahi,Hard,2,1,3,8,66.67
6475,Saeed Meer,Clay,2,4,6,18,33.33
6476,Saeed Meer,Grass,5,7,12,18,41.67
6477,Salifu Mohammed,Clay,1,1,2,7,50.0
6478,Salifu Mohammed,Hard,1,4,5,7,20.0
6479,Salvador Cabeza,Clay,1,6,7,7,14.29
6480,Salvador Colvee,Clay,1,1,2,4,50.0
6481,Salvador Colvee,Hard,1,1,2,4,50.0
6482,Salvador Navarro,Clay,4,7,11,11,36.36
6483,Salvatore Caruso,Clay,7,10,17,42,41.18
6484,Salvatore Caruso,Hard,10,15,25,42,40.0
6485,Sam Barry,Hard,1,6,7,7,14.29
6486,Sam Groth,Clay,1,4,5,99,20.0
6487,Sam Groth,Grass,15,13,28,99,53.57
6488,Sam Groth,Hard,22,44,66,99,33.33
6489,Sam Querrey,Clay,51,63,114,677,44.74
6490,Sam Querrey,Grass,68,38,106,677,64.15
6491,Sam Querrey,Hard,256,201,457,677,56.02
6492,Sam Warburg,Hard,5,9,14,14,35.71
6493,Samir Iftikhar,Hard,2,3,5,5,40.0
6494,Samir Saadeldin,Hard,1,2,3,3,33.33
6495,Sammy Giammalva Jr,Carpet,26,34,60,327,43.33
6496,Sammy Giammalva Jr,Clay,25,33,58,327,43.1
6497,Sammy Giammalva Jr,Grass,29,25,54,327,53.7
6498,Sammy Giammalva Jr,Hard,81,74,155,327,52.26
6499,Samson Ahinakwa,Hard,1,1,2,2,50.0
6500,Sanam Singh,Hard,1,2,3,3,33.33
6501,Sanchai Ratiwatana,Hard,3,3,6,6,50.0
6502,Sander Groen,Carpet,1,2,3,13,33.33
6503,Sander Groen,Grass,1,4,5,13,20.0
6504,Sander Groen,Hard,1,4,5,13,20.0
6505,Sandon Stolle,Carpet,5,6,11,221,45.45
6506,Sandon Stolle,Clay,10,15,25,221,40.0
6507,Sandon Stolle,Grass,28,21,49,221,57.14
6508,Sandon Stolle,Hard,58,78,136,221,42.65
6509,Sandor Kiss,Clay,1,5,6,6,16.67
6510,Sandor Martinez Breijo,Hard,4,6,10,10,40.0
6511,Sandor Noszaly,Carpet,4,8,12,81,33.33
6512,Sandor Noszaly,Clay,22,33,55,81,40.0
6513,Sandor Noszaly,Hard,2,12,14,81,14.29
6514,Sandro Ehrat,Clay,1,3,4,4,25.0
6515,Sandy Mayer,Carpet,127,70,197,536,64.47
6516,Sandy Mayer,Clay,45,30,75,536,60.0
6517,Sandy Mayer,Grass,54,32,86,536,62.79
6518,Sandy Mayer,Hard,115,63,178,536,64.61
6519,Sanjar Fayziev,Clay,1,2,3,3,33.33
6520,Santiago Giraldo,Clay,92,89,181,370,50.83
6521,Santiago Giraldo,Grass,14,17,31,370,45.16
6522,Santiago Giraldo,Hard,61,97,158,370,38.61
6523,Santiago Gonzalez,Clay,6,9,15,19,40.0
6524,Santiago Gonzalez,Hard,3,1,4,19,75.0
6525,Santiago Maresca,Hard,1,2,3,3,33.33
6526,Santiago Ventura,Clay,37,41,78,90,47.44
6527,Santiago Ventura,Hard,1,11,12,90,8.33
6528,Sargis Sargsian,Carpet,16,17,33,366,48.48
6529,Sargis Sargsian,Clay,45,59,104,366,43.27
6530,Sargis Sargsian,Grass,28,30,58,366,48.28
6531,Sargis Sargsian,Hard,68,103,171,366,39.77
6532,Sarvar Ikramov,Clay,1,1,2,8,50.0
6533,Sarvar Ikramov,Hard,2,4,6,8,33.33
6534,Sasa Hirszon,Carpet,3,3,6,35,50.0
6535,Sasa Hirszon,Clay,4,17,21,35,19.05
6536,Sasa Hirszon,Grass,1,1,2,35,50.0
6537,Sasa Hirszon,Hard,2,4,6,35,33.33
6538,Sasa Tuksar,Clay,1,5,6,6,16.67
6539,Sashi Menon,Carpet,13,25,38,275,34.21
6540,Sashi Menon,Clay,46,73,119,275,38.66
6541,Sashi Menon,Grass,13,34,47,275,27.66
6542,Sashi Menon,Hard,22,49,71,275,30.99
6543,Satoshi Iwabuchi,Hard,5,15,20,20,25.0
6544,Schalk Van Der Merwe,Clay,1,6,7,30,14.29
6545,Schalk Van Der Merwe,Grass,1,2,3,30,33.33
6546,Schalk Van Der Merwe,Hard,8,12,20,30,40.0
6547,Scott Barron,Carpet,1,3,4,16,25.0
6548,Scott Barron,Clay,3,2,5,16,60.0
6549,Scott Barron,Hard,2,5,7,16,28.57
6550,Scott Carnahan,Clay,3,3,6,22,50.0
6551,Scott Carnahan,Grass,2,7,9,22,22.22
6552,Scott Carnahan,Hard,2,5,7,22,28.57
6553,Scott Davis,Carpet,43,49,92,404,46.74
6554,Scott Davis,Clay,4,13,17,404,23.53
6555,Scott Davis,Grass,30,29,59,404,50.85
6556,Scott Davis,Hard,129,107,236,404,54.66
6557,Scott Draper,Carpet,7,8,15,237,46.67
6558,Scott Draper,Clay,14,27,41,237,34.15
6559,Scott Draper,Grass,22,23,45,237,48.89
6560,Scott Draper,Hard,65,71,136,237,47.79
6561,Scott Lipton,Clay,4,7,11,18,36.36
6562,Scott Lipton,Hard,2,5,7,18,28.57
6563,Scott Mccain,Carpet,2,3,5,69,40.0
6564,Scott Mccain,Clay,2,6,8,69,25.0
6565,Scott Mccain,Grass,8,19,27,69,29.63
6566,Scott Mccain,Hard,10,19,29,69,34.48
6567,Scott Melville,Hard,5,4,9,9,55.56
6568,Scott Oudsema,Hard,1,3,4,4,25.0
6569,Scott Warner,Hard,3,6,9,9,33.33
6570,Scott Willinsky,Hard,1,4,5,5,20.0
6571,Scoville Jenkins,Clay,2,3,5,21,40.0
6572,Scoville Jenkins,Grass,1,1,2,21,50.0
6573,Scoville Jenkins,Hard,3,11,14,21,21.43
6574,Sean Brawley,Carpet,2,1,3,10,66.67
6575,Sean Brawley,Hard,2,5,7,10,28.57
6576,Sean Karam,Hard,1,1,2,2,50.0
6577,Sean Sorensen,Carpet,2,7,9,50,22.22
6578,Sean Sorensen,Clay,7,13,20,50,35.0
6579,Sean Sorensen,Grass,2,2,4,50,50.0
6580,Sean Sorensen,Hard,8,9,17,50,47.06
6581,Seanon Williams,Hard,1,5,6,6,16.67
6582,Sebastian Arcila,Hard,1,2,3,3,33.33
6583,Sebastian Decoud,Clay,4,3,7,7,57.14
6584,Sebastian Korda,Clay,3,1,4,14,75.0
6585,Sebastian Korda,Hard,5,5,10,14,50.0
6586,Sebastian Ofner,Clay,6,5,11,14,54.55
6587,Sebastian Ofner,Grass,2,1,3,14,66.67
6588,Sebastian Prieto,Clay,3,10,13,15,23.08
6589,Sebastian Prieto,Hard,1,1,2,15,50.0
6590,Sebastian Rieschick,Hard,1,1,2,2,50.0
6591,Sebastien De Chaunac,Clay,1,3,4,32,25.0
6592,Sebastien De Chaunac,Hard,10,18,28,32,35.71
6593,Sebastien Graeff,Clay,1,3,4,6,25.0
6594,Sebastien Graeff,Hard,1,1,2,6,50.0
6595,Sebastien Grosjean,Carpet,32,25,57,590,56.14
6596,Sebastien Grosjean,Clay,88,63,151,590,58.28
6597,Sebastien Grosjean,Grass,49,26,75,590,65.33
6598,Sebastien Grosjean,Hard,173,134,307,590,56.35
6599,Sebastien Lareau,Carpet,18,17,35,238,51.43
6600,Sebastien Lareau,Clay,3,17,20,238,15.0
6601,Sebastien Lareau,Grass,12,19,31,238,38.71
6602,Sebastien Lareau,Hard,67,85,152,238,44.08
6603,Sebastien Leblanc,Hard,2,3,5,5,40.0
6604,Sebastien Vidal,Hard,1,2,3,3,33.33
6605,Sebo Kiss,Clay,4,6,10,18,40.0
6606,Sebo Kiss,Hard,5,3,8,18,62.5
6607,Selvam Veerasingam,Clay,1,1,2,21,50.0
6608,Selvam Veerasingam,Grass,1,1,2,21,50.0
6609,Selvam Veerasingam,Hard,8,9,17,21,47.06
6610,Senaka Kumara,Clay,2,3,5,5,40.0
6611,Seong Chan Hong,Clay,1,1,2,2,50.0
6612,Serge Brueck,Carpet,3,2,5,17,60.0
6613,Serge Brueck,Clay,1,5,6,17,16.67
6614,Serge Brueck,Hard,4,2,6,17,66.67
6615,Sergei Bubka,Carpet,2,1,3,30,66.67
6616,Sergei Bubka,Clay,1,3,4,30,25.0
6617,Sergei Bubka,Grass,1,2,3,30,33.33
6618,Sergei Bubka,Hard,10,10,20,30,50.0
6619,Sergei Likhachev,Clay,5,7,12,12,41.67
6620,Sergei Yaroshenko,Hard,2,3,5,5,40.0
6621,Sergey Makashin,Hard,1,1,2,2,50.0
6622,Sergi Bruguera,Carpet,48,53,101,719,47.52
6623,Sergi Bruguera,Clay,296,135,431,719,68.68
6624,Sergi Bruguera,Grass,5,5,10,719,50.0
6625,Sergi Bruguera,Hard,98,79,177,719,55.37
6626,Sergio Casal,Carpet,20,21,41,273,48.78
6627,Sergio Casal,Clay,82,97,179,273,45.81
6628,Sergio Casal,Grass,1,5,6,273,16.67
6629,Sergio Casal,Hard,22,25,47,273,46.81
6630,Sergio Cortes,Clay,13,21,34,44,38.24
6631,Sergio Cortes,Hard,5,5,10,44,50.0
6632,Sergio Cruz,Grass,1,1,2,2,50.0
6633,Sergio Gutierrez Ferrol,Clay,2,2,4,4,50.0
6634,Sergio Palmieri,Clay,5,13,18,18,27.78
6635,Sergio Ribeiro,Clay,1,1,2,2,50.0
6636,Sergio Roitman,Clay,22,40,62,86,35.48
6637,Sergio Roitman,Grass,1,5,6,86,16.67
6638,Sergio Roitman,Hard,2,16,18,86,11.11
6639,Sergis Kyratzis,Clay,1,2,3,3,33.33
6640,Sergiy Stakhovsky,Carpet,4,6,10,383,40.0
6641,Sergiy Stakhovsky,Clay,33,55,88,383,37.5
6642,Sergiy Stakhovsky,Grass,26,28,54,383,48.15
6643,Sergiy Stakhovsky,Hard,107,124,231,383,46.32
6644,Seung Ho Ji,Hard,1,2,3,3,33.33
6645,Sever Dron,Clay,2,8,10,10,20.0
6646,Sever Muresan,Clay,2,3,5,5,40.0
6647,Seyed Akbar Taheri Rahaghi,Clay,1,3,4,4,25.0
6648,Shahab Hassani Nafez,Clay,5,1,6,9,83.33
6649,Shahab Hassani Nafez,Hard,1,2,3,9,33.33
6650,Shahar Perkiss,Carpet,8,8,16,113,50.0
6651,Shahar Perkiss,Clay,7,12,19,113,36.84
6652,Shahar Perkiss,Grass,6,7,13,113,46.15
6653,Shahar Perkiss,Hard,31,34,65,113,47.69
6654,Shahin Khaledan,Clay,2,1,3,10,66.67
6655,Shahin Khaledan,Hard,2,5,7,10,28.57
6656,Shamil Tarpischev,Clay,2,2,4,4,50.0
6657,Shane Barr,Grass,2,6,8,23,25.0
6658,Shane Barr,Hard,4,11,15,23,26.67
6659,Shao Xuan Zeng,Hard,5,9,14,14,35.71
6660,Sharmal Dissanayake,Clay,2,4,6,9,33.33
6661,Sharmal Dissanayake,Hard,1,2,3,9,33.33
6662,Shelby Cannon,Hard,2,8,10,10,20.0
6663,Sherif Sabry,Clay,4,4,8,15,50.0
6664,Sherif Sabry,Hard,1,6,7,15,14.29
6665,Sherwood Stewart,Carpet,35,63,98,371,35.71
6666,Sherwood Stewart,Clay,42,60,102,371,41.18
6667,Sherwood Stewart,Grass,28,33,61,371,45.9
6668,Sherwood Stewart,Hard,47,63,110,371,42.73
6669,Shigeru Ota,Clay,1,1,2,2,50.0
6670,Shigeyuki Nishio,Clay,6,7,13,20,46.15
6671,Shigeyuki Nishio,Hard,3,4,7,20,42.86
6672,Shinichi Sakamoto,Clay,1,7,8,13,12.5
6673,Shinichi Sakamoto,Hard,2,3,5,13,40.0
6674,Shlomo Glickstein,Carpet,20,31,51,346,39.22
6675,Shlomo Glickstein,Clay,55,43,98,346,56.12
6676,Shlomo Glickstein,Grass,19,21,40,346,47.5
6677,Shlomo Glickstein,Hard,94,63,157,346,59.87
6678,Shovon Jamaly,Hard,5,7,12,12,41.67
6679,Shozo Shiraishi,Carpet,2,5,7,26,28.57
6680,Shozo Shiraishi,Clay,2,5,7,26,28.57
6681,Shozo Shiraishi,Hard,3,9,12,26,25.0
6682,Shu Hua Liu,Carpet,2,2,4,17,50.0
6683,Shu Hua Liu,Clay,5,3,8,17,62.5
6684,Shu Hua Liu,Hard,3,2,5,17,60.0
6685,Shuzo Matsuoka,Carpet,22,28,50,313,44.0
6686,Shuzo Matsuoka,Clay,8,18,26,313,30.77
6687,Shuzo Matsuoka,Grass,24,19,43,313,55.81
6688,Shuzo Matsuoka,Hard,94,100,194,313,48.45
6689,Sidney Gordon,Hard,2,4,6,6,33.33
6690,Simon Greul,Carpet,1,2,3,117,33.33
6691,Simon Greul,Clay,20,32,52,117,38.46
6692,Simon Greul,Grass,3,6,9,117,33.33
6693,Simon Greul,Hard,20,33,53,117,37.74
6694,Simon Larose,Carpet,3,1,4,30,75.0
6695,Simon Larose,Clay,2,9,11,30,18.18
6696,Simon Larose,Hard,6,9,15,30,40.0
6697,Simon Rea,Carpet,2,2,4,4,50.0
6698,Simon Stadler,Grass,3,5,8,16,37.5
6699,Simon Stadler,Hard,3,5,8,16,37.5
6700,Simon Youl,Carpet,7,13,20,234,35.0
6701,Simon Youl,Clay,7,23,30,234,23.33
6702,Simon Youl,Grass,23,34,57,234,40.35
6703,Simon Youl,Hard,56,71,127,234,44.09
6704,Simone Bolelli,Carpet,1,2,3,291,33.33
6705,Simone Bolelli,Clay,56,62,118,291,47.46
6706,Simone Bolelli,Grass,16,16,32,291,50.0
6707,Simone Bolelli,Hard,50,88,138,291,36.23
6708,Simone Colombo,Carpet,3,7,10,89,30.0
6709,Simone Colombo,Clay,30,38,68,89,44.12
6710,Simone Colombo,Grass,1,4,5,89,20.0
6711,Simone Colombo,Hard,1,5,6,89,16.67
6712,Simone Vagnozzi,Clay,4,7,11,11,36.36
6713,Sjeng Schalken,Carpet,31,28,59,562,52.54
6714,Sjeng Schalken,Clay,65,75,140,562,46.43
6715,Sjeng Schalken,Grass,47,30,77,562,61.04
6716,Sjeng Schalken,Hard,151,135,286,562,52.8
6717,Slava Dosedel,Carpet,6,18,24,390,25.0
6718,Slava Dosedel,Clay,147,115,262,390,56.11
6719,Slava Dosedel,Grass,5,10,15,390,33.33
6720,Slava Dosedel,Hard,38,51,89,390,42.7
6721,Slimane Saoudi,Clay,6,12,18,21,33.33
6722,Slimane Saoudi,Hard,1,2,3,21,33.33
6723,Slobodan Zivojinovic,Carpet,27,31,58,296,46.55
6724,Slobodan Zivojinovic,Clay,34,34,68,296,50.0
6725,Slobodan Zivojinovic,Grass,33,18,51,296,64.71
6726,Slobodan Zivojinovic,Hard,61,58,119,296,51.26
6727,Sofronio Palahang,Clay,1,1,2,2,50.0
6728,Solon Peppas,Clay,7,8,15,21,46.67
6729,Solon Peppas,Hard,4,2,6,21,66.67
6730,Sombat Uamongkol,Hard,7,3,10,10,70.0
6731,Somdev Devvarman,Clay,6,15,21,143,28.57
6732,Somdev Devvarman,Grass,3,9,12,143,25.0
6733,Somdev Devvarman,Hard,53,57,110,143,48.18
6734,Sonchat Ratiwatana,Hard,1,4,5,5,20.0
6735,Soon Woo Kwon,Hard,18,17,35,35,51.43
6736,Soren Hess Olesen,Hard,1,2,3,3,33.33
6737,Spencer Segura,Carpet,1,7,8,12,12.5
6738,Spencer Segura,Clay,1,3,4,12,25.0
6739,Srdan Muskatirovic,Carpet,1,4,5,5,20.0
6740,Srinivasan Vasudevan,Clay,1,2,3,14,33.33
6741,Srinivasan Vasudevan,Grass,3,2,5,14,60.0
6742,Srinivasan Vasudevan,Hard,4,2,6,14,66.67
6743,Stan Myerson,Hard,1,2,3,3,33.33
6744,Stan Smith,Carpet,169,76,245,958,68.98
6745,Stan Smith,Clay,152,68,220,958,69.09
6746,Stan Smith,Grass,124,42,166,958,74.7
6747,Stan Smith,Hard,231,96,327,958,70.64
6748,Stan Wawrinka,Carpet,8,9,17,846,47.06
6749,Stan Wawrinka,Clay,185,94,279,846,66.31
6750,Stan Wawrinka,Grass,31,31,62,846,50.0
6751,Stan Wawrinka,Hard,311,177,488,846,63.73
6752,Stanislav Birner,Carpet,8,16,24,184,33.33
6753,Stanislav Birner,Clay,31,64,95,184,32.63
6754,Stanislav Birner,Grass,3,5,8,184,37.5
6755,Stanislav Birner,Hard,21,36,57,184,36.84
6756,Stanley Matthews,Clay,2,9,11,30,18.18
6757,Stanley Matthews,Grass,8,11,19,30,42.11
6758,Stanley Pasarell,Grass,3,5,8,8,37.5
6759,Stefan Edberg,Carpet,182,76,258,1077,70.54
6760,Stefan Edberg,Clay,136,65,201,1077,67.66
6761,Stefan Edberg,Grass,99,27,126,1077,78.57
6762,Stefan Edberg,Hard,387,105,492,1077,78.66
6763,Stefan Eriksson,Carpet,1,3,4,52,25.0
6764,Stefan Eriksson,Clay,7,17,24,52,29.17
6765,Stefan Eriksson,Hard,11,13,24,52,45.83
6766,Stefan Hermann,Clay,1,1,2,2,50.0
6767,Stefan Koubek,Carpet,14,18,32,469,43.75
6768,Stefan Koubek,Clay,95,95,190,469,50.0
6769,Stefan Koubek,Grass,8,19,27,469,29.63
6770,Stefan Koubek,Hard,98,122,220,469,44.55
6771,Stefan Koudelka,Clay,7,9,16,22,43.75
6772,Stefan Koudelka,Grass,2,4,6,22,33.33
6773,Stefan Kozlov,Grass,5,6,11,11,45.45
6774,Stefan Lochbihler,Clay,3,7,10,10,30.0
6775,Stefan Simonsson,Carpet,5,11,16,225,31.25
6776,Stefan Simonsson,Clay,64,74,138,225,46.38
6777,Stefan Simonsson,Grass,8,8,16,225,50.0
6778,Stefan Simonsson,Hard,23,32,55,225,41.82
6779,Stefan Svensson,Clay,1,8,9,13,11.11
6780,Stefan Svensson,Hard,1,3,4,13,25.0
6781,Stefano Cobolli,Clay,1,2,3,3,33.33
6782,Stefano Galvani,Carpet,2,2,4,55,50.0
6783,Stefano Galvani,Clay,9,19,28,55,32.14
6784,Stefano Galvani,Grass,3,4,7,55,42.86
6785,Stefano Galvani,Hard,4,12,16,55,25.0
6786,Stefano Ianni,Clay,1,1,2,2,50.0
6787,Stefano Napolitano,Clay,1,2,3,3,33.33
6788,Stefano Pescosolido,Carpet,7,22,29,268,24.14
6789,Stefano Pescosolido,Clay,44,65,109,268,40.37
6790,Stefano Pescosolido,Grass,5,10,15,268,33.33
6791,Stefano Pescosolido,Hard,53,62,115,268,46.09
6792,Stefano Tarallo,Clay,1,1,2,2,50.0
6793,Stefano Travaglia,Clay,8,9,17,51,47.06
6794,Stefano Travaglia,Hard,14,20,34,51,41.18
6795,Stefanos Tsitsipas,Clay,38,16,54,218,70.37
6796,Stefanos Tsitsipas,Grass,8,7,15,218,53.33
6797,Stefanos Tsitsipas,Hard,95,54,149,218,63.76
6798,Stepan Koudelka,Grass,1,1,2,6,50.0
6799,Stepan Koudelka,Hard,1,3,4,6,25.0
6800,Stephan Rhode,Clay,1,1,2,2,50.0
6801,Stephane Bohli,Carpet,1,4,5,26,20.0
6802,Stephane Bohli,Clay,1,5,6,26,16.67
6803,Stephane Bohli,Hard,4,11,15,26,26.67
6804,Stephane Bonneau,Carpet,2,2,4,24,50.0
6805,Stephane Bonneau,Hard,6,14,20,24,30.0
6806,Stephane Grenier,Clay,1,3,4,4,25.0
6807,Stephane Huet,Clay,7,12,19,48,36.84
6808,Stephane Huet,Grass,2,5,7,48,28.57
6809,Stephane Huet,Hard,5,17,22,48,22.73
6810,Stephane Robert,Clay,13,29,42,113,30.95
6811,Stephane Robert,Grass,4,8,12,113,33.33
6812,Stephane Robert,Hard,21,38,59,113,35.59
6813,Stephane Sansoni,Hard,1,1,2,2,50.0
6814,Stephane Simian,Carpet,6,15,21,125,28.57
6815,Stephane Simian,Clay,4,11,15,125,26.67
6816,Stephane Simian,Grass,12,13,25,125,48.0
6817,Stephane Simian,Hard,23,41,64,125,35.94
6818,Stephen Botfield,Grass,2,6,8,8,25.0
6819,Stephen Furlong,Hard,1,1,2,2,50.0
6820,Stephen Myers,Clay,1,3,4,15,25.0
6821,Stephen Myers,Grass,3,8,11,15,27.27
6822,Stephen Noteboom,Hard,1,1,2,2,50.0
6823,Stephen Warboys,Carpet,1,6,7,44,14.29
6824,Stephen Warboys,Grass,11,18,29,44,37.93
6825,Stephen Warboys,Hard,5,3,8,44,62.5
6826,Steve Bryan,Carpet,2,6,8,106,25.0
6827,Steve Bryan,Clay,3,6,9,106,33.33
6828,Steve Bryan,Grass,2,8,10,106,20.0
6829,Steve Bryan,Hard,29,50,79,106,36.71
6830,Steve Campbell,Carpet,1,4,5,86,20.0
6831,Steve Campbell,Clay,9,12,21,86,42.86
6832,Steve Campbell,Grass,3,5,8,86,37.5
6833,Steve Campbell,Hard,19,33,52,86,36.54
6834,Steve Darcis,Carpet,3,2,5,256,60.0
6835,Steve Darcis,Clay,35,40,75,256,46.67
6836,Steve Darcis,Grass,16,19,35,256,45.71
6837,Steve Darcis,Hard,65,76,141,256,46.1
6838,Steve Denton,Carpet,33,40,73,225,45.21
6839,Steve Denton,Clay,8,14,22,225,36.36
6840,Steve Denton,Grass,26,22,48,225,54.17
6841,Steve Denton,Hard,42,40,82,225,51.22
6842,Steve Devries,Carpet,1,5,6,17,16.67
6843,Steve Devries,Grass,1,2,3,17,33.33
6844,Steve Devries,Hard,2,6,8,17,25.0
6845,Steve Docherty,Carpet,5,13,18,121,27.78
6846,Steve Docherty,Clay,4,10,14,121,28.57
6847,Steve Docherty,Grass,14,19,33,121,42.42
6848,Steve Docherty,Hard,23,33,56,121,41.07
6849,Steve Faulk,Clay,9,27,36,62,25.0
6850,Steve Faulk,Grass,2,7,9,62,22.22
6851,Steve Faulk,Hard,7,10,17,62,41.18
6852,Steve Guy,Carpet,2,5,7,52,28.57
6853,Steve Guy,Clay,3,7,10,52,30.0
6854,Steve Guy,Hard,13,22,35,52,37.14
6855,Steve Johnson,Clay,29,30,59,341,49.15
6856,Steve Johnson,Grass,32,25,57,341,56.14
6857,Steve Johnson,Hard,110,115,225,341,48.89
6858,Steve Krulevitz,Carpet,18,38,56,320,32.14
6859,Steve Krulevitz,Clay,57,89,146,320,39.04
6860,Steve Krulevitz,Grass,12,20,32,320,37.5
6861,Steve Krulevitz,Hard,35,51,86,320,40.7
6862,Steve Meister,Carpet,1,10,11,93,9.09
6863,Steve Meister,Clay,7,12,19,93,36.84
6864,Steve Meister,Grass,6,10,16,93,37.5
6865,Steve Meister,Hard,16,31,47,93,34.04
6866,Steve Shaw,Clay,7,15,22,70,31.82
6867,Steve Shaw,Grass,10,21,31,70,32.26
6868,Steve Shaw,Hard,8,9,17,70,47.06
6869,Steve Tidball,Hard,1,3,4,4,25.0
6870,Steve Turner,Clay,9,28,37,56,24.32
6871,Steve Turner,Grass,2,4,6,56,33.33
6872,Steve Turner,Hard,2,11,13,56,15.38
6873,Steven Diez,Clay,1,6,7,10,14.29
6874,Steven Diez,Hard,1,2,3,10,33.33
6875,Steven Downs,Hard,4,6,10,10,40.0
6876,Steven Kangwa,Clay,1,2,3,3,33.33
6877,Stevenson Clarke,Grass,2,1,3,3,66.67
6878,Stian Boretti,Clay,4,8,12,24,33.33
6879,Stian Boretti,Hard,5,7,12,24,41.67
6880,Stuart Bale,Carpet,2,5,7,23,28.57
6881,Stuart Bale,Grass,2,10,12,23,16.67
6882,Stuart Bale,Hard,1,3,4,23,25.0
6883,Suharyadi Suharyadi,Clay,5,4,9,15,55.56
6884,Suharyadi Suharyadi,Hard,1,5,6,15,16.67
6885,Suk Young Jeong,Hard,4,5,9,9,44.44
6886,Sule Ladipo,Carpet,1,1,2,22,50.0
6887,Sule Ladipo,Clay,1,4,5,22,20.0
6888,Sule Ladipo,Hard,9,6,15,22,60.0
6889,Sultan Aman Azman,Clay,1,1,2,2,50.0
6890,Sultan Khalfan,Hard,2,14,16,16,12.5
6891,Sumit Nagal,Hard,1,10,11,11,9.09
6892,Sun Yong Kim Jr,Hard,2,1,3,3,66.67
6893,Sunny Liu,Hard,1,1,2,2,50.0
6894,Sunu Wahyu Trijati,Hard,3,7,10,10,30.0
6895,Supoj Meesawad,Carpet,1,1,2,2,50.0
6896,Sutarjo Sugiarto,Grass,2,4,6,6,33.33
6897,Suwandi Suwandi,Clay,6,10,16,49,37.5
6898,Suwandi Suwandi,Hard,17,16,33,49,51.52
6899,Syd Ball,Carpet,11,28,39,250,28.21
6900,Syd Ball,Clay,11,33,44,250,25.0
6901,Syd Ball,Grass,52,62,114,250,45.61
6902,Syd Ball,Hard,16,37,53,250,30.19
6903,Syed Nasir Sherazi,Clay,2,1,3,3,66.67
6904,Syrym Abdukhalikov,Hard,2,1,3,3,66.67
6905,Szabolcz Baranyi,Carpet,1,3,4,114,25.0
6906,Szabolcz Baranyi,Clay,28,41,69,114,40.58
6907,Szabolcz Baranyi,Grass,11,8,19,114,57.89
6908,Szabolcz Baranyi,Hard,8,14,22,114,36.36
6909,Tadeusz Nowicki,Carpet,1,2,3,45,33.33
6910,Tadeusz Nowicki,Clay,22,20,42,45,52.38
6911,Taghi Akbari,Clay,1,6,7,12,14.29
6912,Taghi Akbari,Hard,3,2,5,12,60.0
6913,Tai Wei Liu,Hard,1,2,3,3,33.33
6914,Taisen Kanai,Clay,1,4,5,5,20.0
6915,Takahiro Terachi,Hard,4,8,12,12,33.33
6916,Takanyi Garanganga,Hard,4,7,11,11,36.36
6917,Takao Suzuki,Carpet,14,4,18,96,77.78
6918,Takao Suzuki,Clay,3,2,5,96,60.0
6919,Takao Suzuki,Grass,1,5,6,96,16.67
6920,Takao Suzuki,Hard,32,35,67,96,47.76
6921,Takehiko Nishiwaki,Clay,2,4,6,6,33.33
6922,Takeshi Koura,Grass,1,1,2,7,50.0
6923,Takeshi Koura,Hard,1,4,5,7,20.0
6924,Tallon Griekspoor,Hard,3,9,12,12,25.0
6925,Tamer El Sawy,Clay,16,9,25,39,64.0
6926,Tamer El Sawy,Hard,3,11,14,39,21.43
6927,Tanakorn Srichaphan,Clay,1,10,11,40,9.09
6928,Tanakorn Srichaphan,Hard,21,8,29,40,72.41
6929,Tapio Nurminen,Carpet,1,2,3,3,33.33
6930,Tarek El Sakka,Clay,14,7,21,21,66.67
6931,Tarik Benhabiles,Carpet,2,9,11,176,18.18
6932,Tarik Benhabiles,Clay,45,56,101,176,44.55
6933,Tarik Benhabiles,Grass,3,12,15,176,20.0
6934,Tarik Benhabiles,Hard,19,30,49,176,38.78
6935,Tarmo Jokinen,Clay,1,1,2,2,50.0
6936,Taro Daniel,Clay,27,35,62,128,43.55
6937,Taro Daniel,Hard,23,43,66,128,34.85
6938,Taso Vasiliadis,Hard,2,1,3,3,66.67
6939,Tasos Bavelas,Clay,15,15,30,33,50.0
6940,Tasos Bavelas,Hard,1,2,3,33,33.33
6941,Tasuku Iwami,Hard,1,3,4,4,25.0
6942,Tatsuma Ito,Clay,4,9,13,100,30.77
6943,Tatsuma Ito,Grass,8,12,20,100,40.0
6944,Tatsuma Ito,Hard,22,45,67,100,32.84
6945,Taylor Dent,Carpet,6,5,11,293,54.55
6946,Taylor Dent,Clay,4,12,16,293,25.0
6947,Taylor Dent,Grass,29,23,52,293,55.77
6948,Taylor Dent,Hard,113,101,214,293,52.8
6949,Taylor Fritz,Clay,17,16,33,202,51.52
6950,Taylor Fritz,Grass,10,13,23,202,43.48
6951,Taylor Fritz,Hard,73,73,146,202,50.0
6952,Ted Scherman,Hard,1,1,2,2,50.0
6953,Teimuraz Kakoulia,Carpet,2,5,7,56,28.57
6954,Teimuraz Kakoulia,Clay,8,10,18,56,44.44
6955,Teimuraz Kakoulia,Grass,12,11,23,56,52.17
6956,Teimuraz Kakoulia,Hard,3,5,8,56,37.5
6957,Teimuraz Kakulia,Carpet,5,3,8,18,62.5
6958,Teimuraz Kakulia,Clay,4,4,8,18,50.0
6959,Teimuraz Kakulia,Grass,1,1,2,18,50.0
6960,Temur Ismailov,Hard,1,1,2,2,50.0
6961,Tenny Svensson,Carpet,8,11,19,106,42.11
6962,Tenny Svensson,Clay,10,39,49,106,20.41
6963,Tenny Svensson,Grass,2,5,7,106,28.57
6964,Tenny Svensson,Hard,9,22,31,106,29.03
6965,Tennys Sandgren,Clay,8,17,25,98,32.0
6966,Tennys Sandgren,Grass,5,5,10,98,50.0
6967,Tennys Sandgren,Hard,27,36,63,98,42.86
6968,Terence Chia,Hard,2,2,4,4,50.0
6969,Terry Addison,Carpet,8,22,30,139,26.67
6970,Terry Addison,Clay,12,30,42,139,28.57
6971,Terry Addison,Grass,15,14,29,139,51.72
6972,Terry Addison,Hard,10,28,38,139,26.32
6973,Terry Hassall,Grass,1,3,4,4,25.0
6974,Terry Moor,Carpet,58,75,133,468,43.61
6975,Terry Moor,Clay,98,74,172,468,56.98
6976,Terry Moor,Grass,13,14,27,468,48.15
6977,Terry Moor,Hard,71,65,136,468,52.21
6978,Terry Rocavert,Carpet,4,6,10,98,40.0
6979,Terry Rocavert,Clay,7,17,24,98,29.17
6980,Terry Rocavert,Grass,11,23,34,98,32.35
6981,Terry Rocavert,Hard,15,15,30,98,50.0
6982,Terry Ryan,Carpet,1,5,6,109,16.67
6983,Terry Ryan,Clay,13,27,40,109,32.5
6984,Terry Ryan,Grass,18,19,37,109,48.65
6985,Terry Ryan,Hard,9,17,26,109,34.62
6986,Tetsu Kuramitsu,Clay,1,7,8,8,12.5
6987,Teymuraz Gabashvili,Carpet,4,7,11,315,36.36
6988,Teymuraz Gabashvili,Clay,41,64,105,315,39.05
6989,Teymuraz Gabashvili,Grass,6,17,23,315,26.09
6990,Teymuraz Gabashvili,Hard,64,112,176,315,36.36
6991,Thanasi Kokkinakis,Clay,2,6,8,73,25.0
6992,Thanasi Kokkinakis,Grass,3,6,9,73,33.33
6993,Thanasi Kokkinakis,Hard,23,33,56,73,41.07
6994,Thedy Stalder,Clay,1,9,10,10,10.0
6995,Theodoros Angelinos,Clay,1,3,4,4,25.0
6996,Thiago Alves,Clay,1,9,10,34,10.0
6997,Thiago Alves,Grass,2,3,5,34,40.0
6998,Thiago Alves,Hard,4,15,19,34,21.05
6999,Thiago Monteiro,Clay,37,37,74,117,50.0
7000,Thiago Monteiro,Grass,1,2,3,117,33.33
7001,Thiago Monteiro,Hard,12,28,40,117,30.0
7002,Thiago Seyboth Wild,Clay,7,6,13,13,53.85
7003,Thiemo De Bakker,Clay,29,31,60,163,48.33
7004,Thiemo De Bakker,Grass,7,11,18,163,38.89
7005,Thiemo De Bakker,Hard,34,51,85,163,40.0
7006,Thien Nguyen Hoang,Hard,3,3,6,6,50.0
7007,Thierno Ly,Hard,3,7,10,10,30.0
7008,Thierry Ascione,Carpet,2,6,8,72,25.0
7009,Thierry Ascione,Clay,9,21,30,72,30.0
7010,Thierry Ascione,Hard,11,23,34,72,32.35
7011,Thierry Bernasconi,Clay,1,8,9,20,11.11
7012,Thierry Bernasconi,Grass,2,5,7,20,28.57
7013,Thierry Bernasconi,Hard,3,1,4,20,75.0
7014,Thierry Champion,Carpet,10,25,35,266,28.57
7015,Thierry Champion,Clay,58,86,144,266,40.28
7016,Thierry Champion,Grass,11,12,23,266,47.83
7017,Thierry Champion,Hard,23,41,64,266,35.94
7018,Thierry Guardiola,Carpet,1,5,6,59,16.67
7019,Thierry Guardiola,Clay,7,27,34,59,20.59
7020,Thierry Guardiola,Hard,5,14,19,59,26.32
7021,Thierry Pham,Carpet,1,2,3,14,33.33
7022,Thierry Pham,Clay,6,5,11,14,54.55
7023,Thierry Stevaux,Carpet,2,2,4,15,50.0
7024,Thierry Stevaux,Clay,1,10,11,15,9.09
7025,Thierry Tulasne,Carpet,16,26,42,451,38.1
7026,Thierry Tulasne,Clay,175,136,311,451,56.27
7027,Thierry Tulasne,Grass,2,8,10,451,20.0
7028,Thierry Tulasne,Hard,37,51,88,451,42.05
7029,Thierry Van Den Daele,Clay,1,4,5,5,20.0
7030,Thomas Blake,Grass,1,2,3,6,33.33
7031,Thomas Blake,Hard,1,2,3,6,33.33
7032,Thomas Buchmayer,Carpet,4,4,8,25,50.0
7033,Thomas Buchmayer,Clay,6,9,15,25,40.0
7034,Thomas Buchmayer,Grass,1,1,2,25,50.0
7035,Thomas Emmrich,Carpet,2,2,4,4,50.0
7036,Thomas Enqvist,Carpet,77,53,130,750,59.23
7037,Thomas Enqvist,Clay,58,63,121,750,47.93
7038,Thomas Enqvist,Grass,20,21,41,750,48.78
7039,Thomas Enqvist,Hard,293,165,458,750,63.97
7040,Thomas Fabbiano,Clay,6,18,24,86,25.0
7041,Thomas Fabbiano,Grass,8,6,14,86,57.14
7042,Thomas Fabbiano,Hard,13,35,48,86,27.08
7043,Thomas Furst,Clay,1,1,2,2,50.0
7044,Thomas Gollwitzer,Carpet,4,2,6,11,66.67
7045,Thomas Gollwitzer,Clay,1,4,5,11,20.0
7046,Thomas Haldin,Clay,2,10,12,12,16.67
7047,Thomas Hogstedt,Carpet,32,37,69,243,46.38
7048,Thomas Hogstedt,Clay,9,24,33,243,27.27
7049,Thomas Hogstedt,Grass,2,9,11,243,18.18
7050,Thomas Hogstedt,Hard,47,83,130,243,36.15
7051,Thomas Johansson,Carpet,72,40,112,658,64.29
7052,Thomas Johansson,Clay,38,69,107,658,35.51
7053,Thomas Johansson,Grass,48,30,78,658,61.54
7054,Thomas Johansson,Hard,203,158,361,658,56.23
7055,Thomas Larsen,Clay,2,6,8,8,25.0
7056,Thomas Lejus,Clay,8,12,20,33,40.0
7057,Thomas Lejus,Grass,5,8,13,33,38.46
7058,Thomas Muster,Carpet,42,52,94,905,44.68
7059,Thomas Muster,Clay,426,130,556,905,76.62
7060,Thomas Muster,Grass,8,10,18,905,44.44
7061,Thomas Muster,Hard,151,86,237,905,63.71
7062,Thomas Oger,Hard,1,2,3,3,33.33
7063,Thomas Prerovsky,Carpet,1,2,3,5,33.33
7064,Thomas Prerovsky,Grass,1,1,2,5,50.0
7065,Thomas Randby,Clay,2,2,4,4,50.0
7066,Thomas Schiessling,Clay,4,9,13,13,30.77
7067,Thomas Schoorel,Clay,1,1,2,9,50.0
7068,Thomas Schoorel,Hard,2,5,7,9,28.57
7069,Thomas Stalhandske,Clay,1,1,2,4,50.0
7070,Thomas Stalhandske,Hard,1,1,2,4,50.0
7071,Thomaz Bellucci,Clay,128,102,230,420,55.65
7072,Thomaz Bellucci,Grass,6,12,18,420,33.33
7073,Thomaz Bellucci,Hard,69,103,172,420,40.12
7074,Thomaz Koch,Carpet,30,23,53,281,56.6
7075,Thomaz Koch,Clay,76,56,132,281,57.58
7076,Thomaz Koch,Grass,11,23,34,281,32.35
7077,Thomaz Koch,Hard,31,31,62,281,50.0
7078,Thorsten Poelzl,Grass,1,1,2,6,50.0
7079,Thorsten Poelzl,Hard,1,3,4,6,25.0
7080,Thorvald Moe,Hard,1,1,2,2,50.0
7081,Ti Chen,Carpet,2,1,3,28,66.67
7082,Ti Chen,Hard,9,16,25,28,36.0
7083,Tian C Viljoen,Grass,1,2,3,9,33.33
7084,Tian C Viljoen,Hard,3,3,6,9,50.0
7085,Tico Carrero,Grass,2,3,5,8,40.0
7086,Tico Carrero,Hard,1,2,3,8,33.33
7087,Tigre Hank,Hard,1,5,6,6,16.67
7088,Tihomir Grozdanov,Clay,3,1,4,4,75.0
7089,Tim Clayton,Grass,1,1,2,2,50.0
7090,Tim Clements,Grass,2,3,5,5,40.0
7091,Tim Donovan,Hard,3,2,5,5,60.0
7092,Tim Garcia,Clay,3,12,15,15,20.0
7093,Tim Gullikson,Carpet,74,73,147,497,50.34
7094,Tim Gullikson,Clay,30,35,65,497,46.15
7095,Tim Gullikson,Grass,70,39,109,497,64.22
7096,Tim Gullikson,Hard,100,76,176,497,56.82
7097,Tim Henman,Carpet,75,37,112,775,66.96
7098,Tim Henman,Clay,63,56,119,775,52.94
7099,Tim Henman,Grass,85,34,119,775,71.43
7100,Tim Henman,Hard,277,148,425,775,65.18
7101,Tim Mayotte,Carpet,112,63,175,545,64.0
7102,Tim Mayotte,Clay,8,19,27,545,29.63
7103,Tim Mayotte,Grass,90,37,127,545,70.87
7104,Tim Mayotte,Hard,131,85,216,545,60.65
7105,Tim Pawsat,Grass,1,1,2,9,50.0
7106,Tim Pawsat,Hard,2,5,7,9,28.57
7107,Tim Puetz,Grass,1,1,2,2,50.0
7108,Tim Smyczek,Clay,3,9,12,128,25.0
7109,Tim Smyczek,Grass,6,12,18,128,33.33
7110,Tim Smyczek,Hard,34,64,98,128,34.69
7111,Tim Sturdza,Carpet,1,1,2,2,50.0
7112,Tim Wilkison,Carpet,44,72,116,592,37.93
7113,Tim Wilkison,Clay,34,39,73,592,46.58
7114,Tim Wilkison,Grass,73,61,134,592,54.48
7115,Tim Wilkison,Hard,143,126,269,592,53.16
7116,Timo Nieminen,Clay,2,6,8,8,25.0
7117,Timothy Neilly,Hard,1,3,4,4,25.0
7118,Timothy Noonan,Clay,1,3,4,12,25.0
7119,Timothy Noonan,Hard,3,5,8,12,37.5
7120,Tintus Arianto Wibowo,Carpet,3,9,12,30,25.0
7121,Tintus Arianto Wibowo,Clay,9,6,15,30,60.0
7122,Tintus Arianto Wibowo,Hard,2,1,3,30,66.67
7123,Tito Vasquez,Clay,2,12,14,27,14.29
7124,Tito Vasquez,Hard,4,9,13,27,30.77
7125,Tito Vazquez,Clay,2,3,5,9,40.0
7126,Tito Vazquez,Grass,1,1,2,9,50.0
7127,Tito Vazquez,Hard,1,1,2,9,50.0
7128,Tj Middleton,Carpet,2,2,4,4,50.0
7129,Tobias Clemens,Hard,2,1,3,3,66.67
7130,Tobias Kamke,Clay,16,28,44,166,36.36
7131,Tobias Kamke,Grass,11,13,24,166,45.83
7132,Tobias Kamke,Hard,36,62,98,166,36.73
7133,Tobias Summerer,Clay,1,5,6,6,16.67
7134,Tobias Svantesson,Carpet,1,3,4,32,25.0
7135,Tobias Svantesson,Clay,2,6,8,32,25.0
7136,Tobias Svantesson,Hard,8,12,20,32,40.0
7137,Todd Larkham,Clay,1,3,4,17,25.0
7138,Todd Larkham,Grass,1,2,3,17,33.33
7139,Todd Larkham,Hard,1,9,10,17,10.0
7140,Todd Martin,Carpet,52,36,88,649,59.09
7141,Todd Martin,Clay,67,49,116,649,57.76
7142,Todd Martin,Grass,61,25,86,649,70.93
7143,Todd Martin,Hard,232,127,359,649,64.62
7144,Todd Nelson,Carpet,19,20,39,143,48.72
7145,Todd Nelson,Clay,3,7,10,143,30.0
7146,Todd Nelson,Grass,9,17,26,143,34.62
7147,Todd Nelson,Hard,22,46,68,143,32.35
7148,Todd Reid,Grass,3,6,9,35,33.33
7149,Todd Reid,Hard,11,15,26,35,42.31
7150,Todd Widom,Hard,5,5,10,10,50.0
7151,Todd Witsken,Carpet,11,13,24,250,45.83
7152,Todd Witsken,Clay,17,31,48,250,35.42
7153,Todd Witsken,Grass,6,14,20,250,30.0
7154,Todd Witsken,Hard,81,77,158,250,51.27
7155,Todd Woodbridge,Carpet,29,37,66,482,43.94
7156,Todd Woodbridge,Clay,22,37,59,482,37.29
7157,Todd Woodbridge,Grass,45,31,76,482,59.21
7158,Todd Woodbridge,Hard,149,132,281,482,53.02
7159,Todor Enev,Carpet,4,1,5,24,80.0
7160,Todor Enev,Clay,5,8,13,24,38.46
7161,Todor Enev,Hard,2,4,6,24,33.33
7162,Tom Brown,Hard,1,3,4,4,25.0
7163,Tom Cain,Carpet,8,17,25,110,32.0
7164,Tom Cain,Clay,12,17,29,110,41.38
7165,Tom Cain,Grass,5,9,14,110,35.71
7166,Tom Cain,Hard,18,24,42,110,42.86
7167,Tom Christensen,Carpet,4,1,5,19,80.0
7168,Tom Christensen,Clay,3,11,14,19,21.43
7169,Tom Edlefsen,Carpet,8,27,35,177,22.86
7170,Tom Edlefsen,Clay,18,26,44,177,40.91
7171,Tom Edlefsen,Grass,10,14,24,177,41.67
7172,Tom Edlefsen,Hard,30,44,74,177,40.54
7173,Tom Gorman,Carpet,88,68,156,610,56.41
7174,Tom Gorman,Clay,68,56,124,610,54.84
7175,Tom Gorman,Grass,67,50,117,610,57.26
7176,Tom Gorman,Hard,127,86,213,610,59.62
7177,Tom Gullikson,Carpet,53,65,118,443,44.92
7178,Tom Gullikson,Clay,25,30,55,443,45.45
7179,Tom Gullikson,Grass,53,43,96,443,55.21
7180,Tom Gullikson,Hard,87,87,174,443,50.0
7181,Tom Kempers,Carpet,1,1,2,6,50.0
7182,Tom Kempers,Clay,1,3,4,6,25.0
7183,Tom Kreiss,Clay,1,3,4,8,25.0
7184,Tom Kreiss,Grass,2,2,4,8,50.0
7185,Tom Leonard,Carpet,14,37,51,161,27.45
7186,Tom Leonard,Clay,1,20,21,161,4.76
7187,Tom Leonard,Grass,8,12,20,161,40.0
7188,Tom Leonard,Hard,27,42,69,161,39.13
7189,Tom Mott,Carpet,1,1,2,2,50.0
7190,Tom Mozur,Clay,3,5,8,15,37.5
7191,Tom Mozur,Grass,3,4,7,15,42.86
7192,Tom Nijssen,Carpet,18,26,44,129,40.91
7193,Tom Nijssen,Clay,13,28,41,129,31.71
7194,Tom Nijssen,Grass,1,7,8,129,12.5
7195,Tom Nijssen,Hard,13,23,36,129,36.11
7196,Tom Okker,Carpet,160,77,237,808,67.51
7197,Tom Okker,Clay,172,68,240,808,71.67
7198,Tom Okker,Grass,96,31,127,808,75.59
7199,Tom Okker,Hard,139,65,204,808,68.14
7200,Toma Ovici,Carpet,6,7,13,44,46.15
7201,Toma Ovici,Clay,14,15,29,44,48.28
7202,Toma Ovici,Grass,1,1,2,44,50.0
7203,Tomas Anzari,Hard,1,6,7,7,14.29
7204,Tomas Behrend,Carpet,3,2,5,112,60.0
7205,Tomas Behrend,Clay,28,44,72,112,38.89
7206,Tomas Behrend,Hard,11,24,35,112,31.43
7207,Tomas Berdych,Carpet,15,6,21,985,71.43
7208,Tomas Berdych,Clay,158,90,248,985,63.71
7209,Tomas Berdych,Grass,68,31,99,985,68.69
7210,Tomas Berdych,Hard,400,217,617,985,64.83
7211,Tomas Cakl,Carpet,1,2,3,12,33.33
7212,Tomas Cakl,Clay,1,1,2,12,50.0
7213,Tomas Cakl,Hard,1,6,7,12,14.29
7214,Tomas Carbonell,Carpet,16,30,46,417,34.78
7215,Tomas Carbonell,Clay,141,133,274,417,51.46
7216,Tomas Carbonell,Grass,6,11,17,417,35.29
7217,Tomas Carbonell,Hard,31,49,80,417,38.75
7218,Tomas Lynch,Clay,2,6,8,8,25.0
7219,Tomas Machac,Hard,1,2,3,3,33.33
7220,Tomas Martin Etcheverry,Clay,1,1,2,2,50.0
7221,Tomas Nydahl,Carpet,6,8,14,97,42.86
7222,Tomas Nydahl,Clay,21,30,51,97,41.18
7223,Tomas Nydahl,Grass,1,4,5,97,20.0
7224,Tomas Nydahl,Hard,7,20,27,97,25.93
7225,Tomas Smid,Carpet,122,102,224,860,54.46
7226,Tomas Smid,Clay,272,144,416,860,65.38
7227,Tomas Smid,Grass,18,16,34,860,52.94
7228,Tomas Smid,Hard,113,73,186,860,60.75
7229,Tomas Tenconi,Clay,1,2,3,3,33.33
7230,Tomas Zib,Carpet,1,6,7,140,14.29
7231,Tomas Zib,Clay,16,39,55,140,29.09
7232,Tomas Zib,Grass,6,10,16,140,37.5
7233,Tomas Zib,Hard,20,42,62,140,32.26
7234,Tomasz Iwanski,Clay,4,3,7,7,57.14
7235,Tomasz Lichon,Clay,1,1,2,4,50.0
7236,Tomasz Lichon,Hard,1,1,2,4,50.0
7237,Tomislav Brkic,Hard,3,5,8,8,37.5
7238,Tomislav Ternar,Hard,1,2,3,3,33.33
7239,Tomm Warneke,Carpet,1,4,5,22,20.0
7240,Tomm Warneke,Clay,3,6,9,22,33.33
7241,Tomm Warneke,Hard,2,6,8,22,25.0
7242,Tommy Haas,Carpet,38,21,59,919,64.41
7243,Tommy Haas,Clay,134,92,226,919,59.29
7244,Tommy Haas,Grass,57,34,91,919,62.64
7245,Tommy Haas,Hard,343,200,543,919,63.17
7246,Tommy Ho,Carpet,10,12,22,99,45.45
7247,Tommy Ho,Grass,4,6,10,99,40.0
7248,Tommy Ho,Hard,22,45,67,99,32.84
7249,Tommy Paul,Clay,4,5,9,59,44.44
7250,Tommy Paul,Hard,25,25,50,59,50.0
7251,Tommy Robredo,Carpet,14,19,33,895,42.42
7252,Tommy Robredo,Clay,261,133,394,895,66.24
7253,Tommy Robredo,Grass,31,25,56,895,55.36
7254,Tommy Robredo,Hard,228,184,412,895,55.34
7255,Tony Bardsley,Carpet,2,5,7,29,28.57
7256,Tony Bardsley,Clay,1,13,14,29,7.14
7257,Tony Bardsley,Grass,3,3,6,29,50.0
7258,Tony Bardsley,Hard,1,1,2,29,50.0
7259,Tony Dawson,Clay,1,1,2,2,50.0
7260,Tony Giammalva,Carpet,11,17,28,132,39.29
7261,Tony Giammalva,Clay,18,26,44,132,40.91
7262,Tony Giammalva,Grass,8,13,21,132,38.1
7263,Tony Giammalva,Hard,17,22,39,132,43.59
7264,Tony Graham,Carpet,1,8,9,65,11.11
7265,Tony Graham,Clay,4,12,16,65,25.0
7266,Tony Graham,Grass,2,4,6,65,33.33
7267,Tony Graham,Hard,12,22,34,65,35.29
7268,Tony Jonsson,Clay,2,8,10,10,20.0
7269,Tony Lloyd,Grass,2,2,4,4,50.0
7270,Tony Mmoh,Carpet,3,2,5,44,60.0
7271,Tony Mmoh,Clay,8,7,15,44,53.33
7272,Tony Mmoh,Hard,9,15,24,44,37.5
7273,Tony Parun P071,Grass,3,10,13,13,23.08
7274,Tony Pospisil,Clay,1,1,2,2,50.0
7275,Tony Richey,Hard,1,1,2,2,50.0
7276,Tony Roche,Carpet,63,49,112,440,56.25
7277,Tony Roche,Clay,54,23,77,440,70.13
7278,Tony Roche,Grass,125,36,161,440,77.64
7279,Tony Roche,Hard,54,36,90,440,60.0
7280,Toomas Leius,Grass,3,2,5,5,60.0
7281,Torben Ulrich,Carpet,11,29,40,154,27.5
7282,Torben Ulrich,Clay,5,34,39,154,12.82
7283,Torben Ulrich,Grass,18,20,38,154,47.37
7284,Torben Ulrich,Hard,8,29,37,154,21.62
7285,Tore Meinecke,Clay,32,40,72,91,44.44
7286,Tore Meinecke,Grass,1,2,3,91,33.33
7287,Tore Meinecke,Hard,7,9,16,91,43.75
7288,Toru Yonezawa,Clay,4,3,7,7,57.14
7289,Toshihide Matsui,Hard,3,2,5,5,60.0
7290,Toshihisa Tsuchihashi,Clay,1,1,2,18,50.0
7291,Toshihisa Tsuchihashi,Hard,6,10,16,18,37.5
7292,Toshiro Sakai,Clay,12,20,32,70,37.5
7293,Toshiro Sakai,Grass,11,13,24,70,45.83
7294,Toshiro Sakai,Hard,9,5,14,70,64.29
7295,Toufiq Zhalan,Hard,1,1,2,2,50.0
7296,Travis Rettenmaier,Grass,1,1,2,4,50.0
7297,Travis Rettenmaier,Hard,1,1,2,4,50.0
7298,Treat Conrad Huey,Clay,5,3,8,14,62.5
7299,Treat Conrad Huey,Hard,3,3,6,14,50.0
7300,Tres Cushing,Grass,1,1,2,2,50.0
7301,Trevor Allan,Clay,23,29,52,52,44.23
7302,Trevor Baker,Grass,1,1,2,2,50.0
7303,Trevor Fancutt,Grass,1,3,4,4,25.0
7304,Trevor Little,Grass,2,5,7,7,28.57
7305,Trey Waltke,Carpet,29,55,84,282,34.52
7306,Trey Waltke,Clay,18,44,62,282,29.03
7307,Trey Waltke,Grass,5,10,15,282,33.33
7308,Trey Waltke,Hard,57,64,121,282,47.11
7309,Tristan Lamasine,Clay,2,3,5,8,40.0
7310,Tristan Lamasine,Hard,1,2,3,8,33.33
7311,Tsung Hua Yang,Hard,5,16,21,21,23.81
7312,Tsuyoshi Fukui,Carpet,8,18,26,72,30.77
7313,Tsuyoshi Fukui,Clay,10,11,21,72,47.62
7314,Tsuyoshi Fukui,Hard,16,9,25,72,64.0
7315,Tucker Vorster,Clay,1,1,2,7,50.0
7316,Tucker Vorster,Hard,4,1,5,7,80.0
7317,Tung Lin Wu,Hard,2,1,3,3,66.67
7318,Tung Yi Kho,Hard,2,1,3,3,66.67
7319,Tuomas Ketola,Carpet,8,13,21,75,38.1
7320,Tuomas Ketola,Clay,3,9,12,75,25.0
7321,Tuomas Ketola,Grass,1,5,6,75,16.67
7322,Tuomas Ketola,Hard,13,23,36,75,36.11
7323,U Hoigshoidt,Carpet,1,1,2,2,50.0
7324,U Lockington,Clay,1,1,2,2,50.0
7325,U Montona,Carpet,1,1,2,2,50.0
7326,U Unknown,Carpet,2,15,17,165,11.76
7327,U Unknown,Clay,11,85,96,165,11.46
7328,U Unknown,Grass,1,28,29,165,3.45
7329,U Unknown,Hard,2,21,23,165,8.7
7330,U Zerngibl,Clay,1,1,2,2,50.0
7331,Udo Riglewski,Carpet,13,12,25,122,52.0
7332,Udo Riglewski,Clay,18,39,57,122,31.58
7333,Udo Riglewski,Grass,2,3,5,122,40.0
7334,Udo Riglewski,Hard,10,25,35,122,28.57
7335,Ugo Humbert,Clay,5,7,12,83,41.67
7336,Ugo Humbert,Grass,6,4,10,83,60.0
7337,Ugo Humbert,Hard,33,28,61,83,54.1
7338,Ugo Nastasi,Hard,2,7,9,9,22.22
7339,Uladzimir Ignatik,Clay,3,8,11,28,27.27
7340,Uladzimir Ignatik,Hard,11,6,17,28,64.71
7341,Ulf Eriksson,Carpet,1,2,3,25,33.33
7342,Ulf Eriksson,Clay,4,8,12,25,33.33
7343,Ulf Eriksson,Hard,4,6,10,25,40.0
7344,Ulf Stenlund,Carpet,2,4,6,96,33.33
7345,Ulf Stenlund,Clay,41,29,70,96,58.57
7346,Ulf Stenlund,Grass,2,3,5,96,40.0
7347,Ulf Stenlund,Hard,7,8,15,96,46.67
7348,Ulrich Marten,Carpet,2,3,5,63,40.0
7349,Ulrich Marten,Clay,7,25,32,63,21.88
7350,Ulrich Marten,Grass,11,15,26,63,42.31
7351,Ulrich Pinner,Carpet,6,14,20,271,30.0
7352,Ulrich Pinner,Clay,116,90,206,271,56.31
7353,Ulrich Pinner,Grass,9,9,18,271,50.0
7354,Ulrich Pinner,Hard,13,14,27,271,48.15
7355,Umesha Wallooppillai,Clay,7,4,11,11,63.64
7356,Uros Vico,Carpet,1,2,3,5,33.33
7357,Uros Vico,Hard,1,1,2,5,50.0
7358,Uwe Gottschalk,Clay,2,4,6,6,33.33
7359,Vaclav Roubicek,Clay,4,9,13,13,30.77
7360,Vadim Borisov,Carpet,6,5,11,17,54.55
7361,Vadim Borisov,Clay,4,2,6,17,66.67
7362,Vadim Kutsenko,Carpet,3,1,4,43,75.0
7363,Vadim Kutsenko,Clay,2,6,8,43,25.0
7364,Vadim Kutsenko,Hard,12,19,31,43,38.71
7365,Valentin Sanon,Carpet,1,6,7,30,14.29
7366,Valentin Sanon,Clay,3,6,9,30,33.33
7367,Valentin Sanon,Hard,5,9,14,30,35.71
7368,Vallis Wilder,Grass,4,4,8,8,50.0
7369,Van Bay Vo,Grass,2,1,3,3,66.67
7370,Van Thanh Vo,Grass,1,4,5,5,20.0
7371,Van Winitsky,Carpet,21,28,49,240,42.86
7372,Van Winitsky,Clay,48,57,105,240,45.71
7373,Van Winitsky,Grass,2,10,12,240,16.67
7374,Van Winitsky,Hard,35,39,74,240,47.3
7375,Vasek Pospisil,Clay,1,19,20,275,5.0
7376,Vasek Pospisil,Grass,16,25,41,275,39.02
7377,Vasek Pospisil,Hard,105,109,214,275,49.07
7378,Vasilis Mazarakis,Carpet,2,1,3,19,66.67
7379,Vasilis Mazarakis,Clay,4,6,10,19,40.0
7380,Vasilis Mazarakis,Hard,2,4,6,19,33.33
7381,Veli Paloheimo,Carpet,8,14,22,110,36.36
7382,Veli Paloheimo,Clay,16,18,34,110,47.06
7383,Veli Paloheimo,Grass,5,7,12,110,41.67
7384,Veli Paloheimo,Hard,20,22,42,110,47.62
7385,Vernon Lewis,Hard,4,4,8,8,50.0
7386,Vicente Zarazua,Clay,2,6,8,8,25.0
7387,Victor Amaya,Carpet,52,41,93,358,55.91
7388,Victor Amaya,Clay,36,51,87,358,41.38
7389,Victor Amaya,Grass,42,32,74,358,56.76
7390,Victor Amaya,Hard,57,47,104,358,54.81
7391,Victor Caldarelli,Clay,1,6,7,13,14.29
7392,Victor Caldarelli,Hard,4,2,6,13,66.67
7393,Victor Crivoi,Clay,12,24,36,51,33.33
7394,Victor Crivoi,Grass,1,2,3,51,33.33
7395,Victor Crivoi,Hard,3,9,12,51,25.0
7396,Victor Egorov,Clay,3,3,6,6,50.0
7397,Victor Eke,Grass,1,7,8,8,12.5
7398,Victor Estrella,Clay,44,26,70,158,62.86
7399,Victor Estrella,Grass,4,13,17,158,23.53
7400,Victor Estrella,Hard,31,40,71,158,43.66
7401,Victor Hanescu,Carpet,5,11,16,443,31.25
7402,Victor Hanescu,Clay,130,110,240,443,54.17
7403,Victor Hanescu,Grass,13,19,32,443,40.62
7404,Victor Hanescu,Hard,53,102,155,443,34.19
7405,Victor Ionita,Clay,1,3,4,4,25.0
7406,Victor Pecci,Carpet,23,24,47,623,48.94
7407,Victor Pecci,Clay,283,178,461,623,61.39
7408,Victor Pecci,Grass,22,17,39,623,56.41
7409,Victor Pecci,Hard,42,34,76,623,55.26
7410,Victor Sendin,Clay,1,2,3,3,33.33
7411,Vijay Amritraj,Carpet,102,90,192,676,53.12
7412,Vijay Amritraj,Clay,74,64,138,676,53.62
7413,Vijay Amritraj,Grass,94,51,145,676,64.83
7414,Vijay Amritraj,Hard,107,94,201,676,53.23
7415,Viktor Durasovic,Hard,2,8,10,10,20.0
7416,Viktor Galovic,Clay,3,4,7,7,42.86
7417,Viktor Nagy,Clay,1,1,2,2,50.0
7418,Viktor Troicki,Clay,71,68,139,569,51.08
7419,Viktor Troicki,Grass,32,30,62,569,51.61
7420,Viktor Troicki,Hard,194,174,368,569,52.72
7421,Ville Liukko,Carpet,7,2,9,31,77.78
7422,Ville Liukko,Clay,2,4,6,31,33.33
7423,Ville Liukko,Hard,7,9,16,31,43.75
7424,Vimuktha De Alwis,Clay,1,1,2,2,50.0
7425,Vincent Millot,Hard,8,18,26,26,30.77
7426,Vincent Spadea,Carpet,18,23,41,671,43.9
7427,Vincent Spadea,Clay,69,93,162,671,42.59
7428,Vincent Spadea,Grass,27,39,66,671,40.91
7429,Vincent Spadea,Hard,198,204,402,671,49.25
7430,Vincent Van Patten,Carpet,50,39,89,226,56.18
7431,Vincent Van Patten,Clay,4,10,14,226,28.57
7432,Vincent Van Patten,Grass,2,8,10,226,20.0
7433,Vincent Van Patten,Hard,53,60,113,226,46.9
7434,Vincenzo Franchitti,Carpet,2,2,4,43,50.0
7435,Vincenzo Franchitti,Clay,11,28,39,43,28.21
7436,Vincenzo Santopadre,Clay,11,17,28,44,39.29
7437,Vincenzo Santopadre,Grass,1,2,3,44,33.33
7438,Vincenzo Santopadre,Hard,5,8,13,44,38.46
7439,Viorel Marcu,Clay,1,3,4,4,25.0
7440,Vishnu Vardhan,Hard,1,3,4,4,25.0
7441,Vitas Gerulaitis,Carpet,175,87,262,737,66.79
7442,Vitas Gerulaitis,Clay,135,55,190,737,71.05
7443,Vitas Gerulaitis,Grass,59,28,87,737,67.82
7444,Vitas Gerulaitis,Hard,145,53,198,737,73.23
7445,Vittaya Samrej,Hard,2,2,4,4,50.0
7446,Vittorio Crotta,Clay,6,13,19,22,31.58
7447,Vittorio Crotta,Grass,1,2,3,22,33.33
7448,Vladimir Gabrichidze,Clay,6,4,10,10,60.0
7449,Vladimir Ivanov,Hard,5,1,6,6,83.33
7450,Vladimir Korotkov,Clay,15,11,26,41,57.69
7451,Vladimir Korotkov,Grass,6,6,12,41,50.0
7452,Vladimir Korotkov,Hard,1,2,3,41,33.33
7453,Vladimir Voltchkov,Carpet,20,15,35,165,57.14
7454,Vladimir Voltchkov,Clay,4,17,21,165,19.05
7455,Vladimir Voltchkov,Grass,10,12,22,165,45.45
7456,Vladimir Voltchkov,Hard,40,47,87,165,45.98
7457,Vladimir Zednik,Carpet,21,37,58,257,36.21
7458,Vladimir Zednik,Clay,59,63,122,257,48.36
7459,Vladimir Zednik,Grass,9,16,25,257,36.0
7460,Vladimir Zednik,Hard,18,34,52,257,34.62
7461,Vladyslav Manafov,Hard,1,1,2,2,50.0
7462,Wade Mcguire,Clay,4,6,10,23,40.0
7463,Wade Mcguire,Hard,3,10,13,23,23.08
7464,Wai Yaw Liu,Hard,3,3,6,6,50.0
7465,Waldemar Rogowski,Clay,3,7,10,10,30.0
7466,Walid Jallali,Clay,3,2,5,7,60.0
7467,Walid Jallali,Hard,1,1,2,7,50.0
7468,Wally Masur,Carpet,52,52,104,615,50.0
7469,Wally Masur,Clay,24,50,74,615,32.43
7470,Wally Masur,Grass,112,62,174,615,64.37
7471,Wally Masur,Hard,141,122,263,615,53.61
7472,Walter Lanz,Clay,1,1,2,2,50.0
7473,Walter Redondo,Hard,3,3,6,6,50.0
7474,Wanaro N'Godrella,Clay,16,33,49,89,32.65
7475,Wanaro N'Godrella,Grass,13,12,25,89,52.0
7476,Wanaro N'Godrella,Hard,5,10,15,89,33.33
7477,Wanaro Ngodrella,Clay,9,9,18,30,50.0
7478,Wanaro Ngodrella,Grass,5,7,12,30,41.67
7479,Warit Sornbutnark,Hard,2,4,6,6,33.33
7480,Warren Jacques,Grass,1,3,4,4,25.0
7481,Warren Maher,Carpet,1,3,4,51,25.0
7482,Warren Maher,Clay,8,14,22,51,36.36
7483,Warren Maher,Grass,9,16,25,51,36.0
7484,Warrick Jones,Hard,1,1,2,2,50.0
7485,Wayne Arthurs,Carpet,3,4,7,294,42.86
7486,Wayne Arthurs,Clay,20,34,54,294,37.04
7487,Wayne Arthurs,Grass,39,30,69,294,56.52
7488,Wayne Arthurs,Hard,72,92,164,294,43.9
7489,Wayne Black,Carpet,14,11,25,185,56.0
7490,Wayne Black,Clay,7,16,23,185,30.43
7491,Wayne Black,Grass,7,12,19,185,36.84
7492,Wayne Black,Hard,53,65,118,185,44.92
7493,Wayne Ferreira,Carpet,57,58,115,843,49.57
7494,Wayne Ferreira,Clay,90,66,156,843,57.69
7495,Wayne Ferreira,Grass,68,35,103,843,66.02
7496,Wayne Ferreira,Hard,297,172,469,843,63.33
7497,Wayne Hampson,Carpet,2,3,5,41,40.0
7498,Wayne Hampson,Clay,1,6,7,41,14.29
7499,Wayne Hampson,Grass,7,18,25,41,28.0
7500,Wayne Hampson,Hard,1,3,4,41,25.0
7501,Wayne Hearn,Hard,1,1,2,2,50.0
7502,Wayne Odesnik,Clay,19,14,33,96,57.58
7503,Wayne Odesnik,Hard,22,41,63,96,34.92
7504,Wayne Pascoe,Carpet,2,3,5,22,40.0
7505,Wayne Pascoe,Grass,6,8,14,22,42.86
7506,Wayne Pascoe,Hard,1,2,3,22,33.33
7507,Weerapat Doakmaiklee,Hard,1,5,6,6,16.67
7508,Wei Jen Cheng,Hard,4,5,9,9,44.44
7509,Wei Ju Chen,Clay,2,1,3,8,66.67
7510,Wei Ju Chen,Hard,2,3,5,8,40.0
7511,Wei You,Clay,6,5,11,14,54.55
7512,Wei You,Hard,2,1,3,14,66.67
7513,Welry Fritz,Clay,5,7,12,17,41.67
7514,Welry Fritz,Hard,1,4,5,17,20.0
7515,Werner Eschauer,Clay,12,25,37,54,32.43
7516,Werner Eschauer,Grass,1,2,3,54,33.33
7517,Werner Eschauer,Hard,2,12,14,54,14.29
7518,Werner Zirngibl,Clay,36,60,96,112,37.5
7519,Werner Zirngibl,Grass,2,3,5,112,40.0
7520,Werner Zirngibl,Hard,4,7,11,112,36.36
7521,Wesley Moodie,Carpet,7,6,13,125,53.85
7522,Wesley Moodie,Grass,10,13,23,125,43.48
7523,Wesley Moodie,Hard,41,48,89,125,46.07
7524,Wesley Whitehouse,Grass,1,2,3,11,33.33
7525,Wesley Whitehouse,Hard,3,5,8,11,37.5
7526,West Nott,Hard,4,2,6,6,66.67
7527,Whitney Reed,Carpet,1,2,3,7,33.33
7528,Whitney Reed,Hard,1,3,4,7,25.0
7529,Wieslaw Gasiorek,Clay,20,14,34,34,58.82
7530,Wilfredo Gonzalez,Hard,4,4,8,8,50.0
7531,Wilhelm Bungert,Carpet,2,1,3,61,66.67
7532,Wilhelm Bungert,Clay,31,20,51,61,60.78
7533,Wilhelm Bungert,Grass,3,4,7,61,42.86
7534,Willem Prinsloo,Carpet,1,3,4,43,25.0
7535,Willem Prinsloo,Clay,4,16,20,43,20.0
7536,Willem Prinsloo,Hard,8,11,19,43,42.11
7537,William Alvarez,Clay,3,10,13,13,23.08
7538,William Brown,Carpet,2,11,13,75,15.38
7539,William Brown,Clay,7,17,24,75,29.17
7540,William Brown,Grass,5,12,17,75,29.41
7541,William Brown,Hard,2,19,21,75,9.52
7542,William Coghlan,Grass,4,9,13,13,30.77
7543,William Collins,Grass,1,1,2,2,50.0
7544,William Durham,Clay,1,1,2,19,50.0
7545,William Durham,Grass,5,12,17,19,29.41
7546,William Harris,Clay,5,4,9,9,55.56
7547,William Higgins,Clay,7,17,24,46,29.17
7548,William Higgins,Grass,4,7,11,46,36.36
7549,William Higgins,Hard,3,8,11,46,27.27
7550,William Mason,Hard,1,2,3,3,33.33
7551,William Tym,Clay,1,8,9,9,11.11
7552,Willie Davies,Grass,2,2,4,4,50.0
7553,Wing Luen Wong,Hard,10,8,18,18,55.56
7554,Wishaya Trongcharoenchaikul,Clay,5,3,8,18,62.5
7555,Wishaya Trongcharoenchaikul,Grass,1,1,2,18,50.0
7556,Wishaya Trongcharoenchaikul,Hard,5,3,8,18,62.5
7557,Wisnu Adi Nugroho,Hard,1,5,6,6,16.67
7558,Witold Meres,Clay,1,1,2,2,50.0
7559,Wojtek Fibak,Carpet,149,98,247,837,60.32
7560,Wojtek Fibak,Clay,243,127,370,837,65.68
7561,Wojtek Fibak,Grass,23,16,39,837,58.97
7562,Wojtek Fibak,Hard,116,65,181,837,64.09
7563,Wojtek Kowalski,Carpet,1,1,2,43,50.0
7564,Wojtek Kowalski,Clay,14,13,27,43,51.85
7565,Wojtek Kowalski,Hard,7,7,14,43,50.0
7566,Wolfgang Popp,Carpet,1,13,14,111,7.14
7567,Wolfgang Popp,Clay,24,46,70,111,34.29
7568,Wolfgang Popp,Grass,4,5,9,111,44.44
7569,Wolfgang Popp,Hard,6,12,18,111,33.33
7570,Wolfgang Schranz,Clay,7,10,17,19,41.18
7571,Wolfgang Schranz,Hard,1,1,2,19,50.0
7572,Woody Blocher,Clay,2,12,14,31,14.29
7573,Woody Blocher,Grass,1,7,8,31,12.5
7574,Woody Blocher,Hard,1,8,9,31,11.11
7575,Woody Hunt,Carpet,1,1,2,5,50.0
7576,Woody Hunt,Hard,1,2,3,5,33.33
7577,Woong Sun Jun,Clay,3,5,8,20,37.5
7578,Woong Sun Jun,Hard,6,6,12,20,50.0
7579,Worapol Thongkamcho,Clay,3,4,7,45,42.86
7580,Worapol Thongkamcho,Hard,28,10,38,45,73.68
7581,Wouter Fok,Clay,2,2,4,4,50.0
7582,X Zhao,Carpet,1,1,2,2,50.0
7583,Xavier Daufresne,Clay,6,14,20,40,30.0
7584,Xavier Daufresne,Hard,10,10,20,40,50.0
7585,Xavier Malisse,Carpet,21,16,37,568,56.76
7586,Xavier Malisse,Clay,58,59,117,568,49.57
7587,Xavier Malisse,Grass,50,30,80,568,62.5
7588,Xavier Malisse,Hard,165,169,334,568,49.4
7589,Xin Yuan Yu,Carpet,1,1,2,13,50.0
7590,Xin Yuan Yu,Hard,4,7,11,13,36.36
7591,Yahiya Doumbia,Carpet,9,9,18,78,50.0
7592,Yahiya Doumbia,Clay,3,10,13,78,23.08
7593,Yahiya Doumbia,Hard,31,16,47,78,65.96
7594,Yakubu Suleiman,Clay,1,1,2,2,50.0
7595,Yan Bai,Hard,5,8,13,13,38.46
7596,Yang Tat Lim,Hard,1,5,6,6,16.67
7597,Yann Marti,Clay,2,5,7,7,28.57
7598,Yannick Hanfmann,Clay,14,13,27,35,51.85
7599,Yannick Hanfmann,Grass,1,1,2,35,50.0
7600,Yannick Hanfmann,Hard,1,5,6,35,16.67
7601,Yannick Maden,Clay,4,5,9,24,44.44
7602,Yannick Maden,Hard,5,10,15,24,33.33
7603,Yannick Mertens,Hard,1,2,3,3,33.33
7604,Yannick Noah,Carpet,89,56,145,696,61.38
7605,Yannick Noah,Clay,214,76,290,696,73.79
7606,Yannick Noah,Grass,15,18,33,696,45.45
7607,Yannick Noah,Hard,164,64,228,696,71.93
7608,Yaoki Ishii,Carpet,3,1,4,4,75.0
7609,Yaraslau Shyla,Hard,3,3,6,6,50.0
7610,Yassine Idmbarek,Clay,4,3,7,10,57.14
7611,Yassine Idmbarek,Hard,1,2,3,10,33.33
7612,Yasufumi Yamamoto,Carpet,6,5,11,26,54.55
7613,Yasufumi Yamamoto,Hard,3,12,15,26,20.0
7614,Yasutaka Uchiyama,Hard,9,17,26,26,34.62
7615,Yavuz Erkangil,Hard,3,3,6,6,50.0
7616,Yehoshua Shalem,Hard,5,7,12,12,41.67
7617,Yen Hsun Lu,Carpet,3,3,6,392,50.0
7618,Yen Hsun Lu,Clay,6,20,26,392,23.08
7619,Yen Hsun Lu,Grass,28,36,64,392,43.75
7620,Yen Hsun Lu,Hard,124,172,296,392,41.89
7621,Yevgeny Kafelnikov,Carpet,166,60,226,920,73.45
7622,Yevgeny Kafelnikov,Clay,141,103,244,920,57.79
7623,Yevgeny Kafelnikov,Grass,46,20,66,920,69.7
7624,Yevgeny Kafelnikov,Hard,260,124,384,920,67.71
7625,Yew Ming Si,Hard,5,7,12,12,41.67
7626,Yibing Wu,Hard,3,8,11,11,27.27
7627,Yohny Romero,Clay,2,2,4,17,50.0
7628,Yohny Romero,Hard,6,7,13,17,46.15
7629,Yong Il Yoon,Carpet,7,4,11,37,63.64
7630,Yong Il Yoon,Clay,5,3,8,37,62.5
7631,Yong Il Yoon,Hard,8,10,18,37,44.44
7632,Yong Kyu Lim,Grass,1,1,2,16,50.0
7633,Yong Kyu Lim,Hard,10,4,14,16,71.43
7634,Yordan Kanev,Carpet,1,1,2,6,50.0
7635,Yordan Kanev,Clay,1,3,4,6,25.0
7636,Yoshihito Nishioka,Clay,4,12,16,138,25.0
7637,Yoshihito Nishioka,Hard,63,59,122,138,51.64
7638,Yosuke Watanuki,Hard,2,3,5,5,40.0
7639,Younes El Aynaoui,Carpet,12,19,31,502,38.71
7640,Younes El Aynaoui,Clay,154,110,264,502,58.33
7641,Younes El Aynaoui,Grass,10,10,20,502,50.0
7642,Younes El Aynaoui,Hard,94,93,187,502,50.27
7643,Younes Rachidi,Hard,1,1,2,2,50.0
7644,Young Dae Jeon,Clay,5,2,7,7,71.43
7645,Young Jun Kim,Hard,4,3,7,7,57.14
7646,Youssef Hossam,Hard,2,1,3,3,66.67
7647,Yu Hui Lien,Clay,1,7,8,21,12.5
7648,Yu Hui Lien,Hard,8,5,13,21,61.54
7649,Yu Jr Wang,Hard,7,11,18,18,38.89
7650,Yu Zhang,Hard,4,13,17,17,23.53
7651,Yu Zheng,Hard,2,1,3,3,66.67
7652,Yue Wei Wang,Hard,1,2,3,3,33.33
7653,Yuichi Sugita,Clay,3,14,17,140,17.65
7654,Yuichi Sugita,Grass,14,14,28,140,50.0
7655,Yuichi Sugita,Hard,37,58,95,140,38.95
7656,Yuji Tezuka,Clay,1,2,3,5,33.33
7657,Yuji Tezuka,Hard,1,1,2,5,50.0
7658,Yuki Bhambri,Clay,1,2,3,49,33.33
7659,Yuki Bhambri,Hard,21,25,46,49,45.65
7660,Yuri Schukin,Clay,13,13,26,35,50.0
7661,Yuri Schukin,Hard,1,8,9,35,11.11
7662,Yves Allegro,Grass,4,6,10,10,40.0
7663,Zacharie Moungnol,Hard,2,2,4,4,50.0
7664,Zack Fleishman,Grass,1,2,3,24,33.33
7665,Zack Fleishman,Hard,6,15,21,24,28.57
7666,Zan Guerry,Clay,23,35,58,90,39.66
7667,Zan Guerry,Grass,2,6,8,90,25.0
7668,Zan Guerry,Hard,7,17,24,90,29.17
7669,Zdravko Mincek,Clay,1,1,2,2,50.0
7670,Ze Zhang,Clay,5,3,8,57,62.5
7671,Ze Zhang,Grass,1,2,3,57,33.33
7672,Ze Zhang,Hard,12,34,46,57,26.09
7673,Zeeshan Ali,Grass,1,9,10,19,10.0
7674,Zeeshan Ali,Hard,3,6,9,19,33.33
7675,Zeljko Franulovic,Carpet,32,62,94,630,34.04
7676,Zeljko Franulovic,Clay,277,162,439,630,63.1
7677,Zeljko Franulovic,Grass,6,8,14,630,42.86
7678,Zeljko Franulovic,Hard,41,42,83,630,49.4
7679,Zeljko Krajan,Clay,7,19,26,35,26.92
7680,Zeljko Krajan,Hard,2,7,9,35,22.22
7681,Zhao Xie,Clay,1,2,3,3,33.33
7682,Zhe Li,Hard,4,13,17,17,23.53
7683,Zhizhen Zhang,Hard,5,7,12,12,41.67
7684,Zizou Bergs,Hard,1,1,2,2,50.0
7685,Zoltan Ilin,Clay,4,6,10,10,40.0
7686,Zoltan Kuharszky,Carpet,6,9,15,115,40.0
7687,Zoltan Kuharszky,Clay,28,44,72,115,38.89
7688,Zoltan Kuharszky,Grass,3,5,8,115,37.5
7689,Zoltan Kuharszky,Hard,6,14,20,115,30.0
7690,Zsombor Piros,Clay,1,2,3,5,33.33
7691,Zsombor Piros,Hard,1,1,2,5,50.0
